region,private_hei,bacc,ms_or_ma,phd,total
I (Ilocos Region),The Adelphi College,12,7,7,26
I (Ilocos Region),Malasiqui Agno Valley College,17,12,2,31
I (Ilocos Region),Agoo Computer College Philippines,10,3,1,14
I (Ilocos Region),Asbury College,2,6,3,11
I (Ilocos Region),Asia Career College Foundation,7,7,1,15
I (Ilocos Region),Baccarra Medical Center School of Midwifery,9,1,0,10
I (Ilocos Region),CICOSAT Colleges,30,14,6,50
I (Ilocos Region),Colegio de Dagupan,40,65,13,118
I (Ilocos Region),Dagupan Colleges Foundation,0,14,2,16
I (Ilocos Region),Data Center College of the Philippines-Laoag City,44,8,4,56
I (Ilocos Region),Divine Word College of Laoag,59,45,6,110
I (Ilocos Region),Divine Word College of Urdaneta,11,7,2,20
I (Ilocos Region),Divine Word College of Vigan,19,22,6,47
I (Ilocos Region),Escuela De Nuestra Senora De La Salette,10,9,0,19
I (Ilocos Region),The Great Plebeian College,19,13,4,36
I (Ilocos Region),Lorma Colleges,93,67,9,169
I (Ilocos Region),Luna Colleges,14,4,3,21
I (Ilocos Region),University of Luzon,110,69,25,204
I (Ilocos Region),Lyceum Northern Luzon,48,8,6,62
I (Ilocos Region),Mary Help of Christians College Seminary,4,11,6,21
I (Ilocos Region),National College of Science and Technology-La Union,11,8,1,20
I (Ilocos Region),Northern Christian College,35,24,7,66
I (Ilocos Region),Northern Luzon Adventist College,14,28,7,49
I (Ilocos Region),"Northern Philippines College for Maritime, Science and Technology",55,26,6,87
I (Ilocos Region),Northwestern University,107,51,14,172
I (Ilocos Region),Osias Educational Foundation,8,2,4,14
I (Ilocos Region),Palaris College,11,11,7,29
I (Ilocos Region),Panpacific University North Philippines-Urdaneta City,134,42,18,194
I (Ilocos Region),Pangasinan Merchant Marine Academy,8,13,3,24
I (Ilocos Region),Perpetual Help College of Pangasinan,30,14,5,49
I (Ilocos Region),Polytechnic College of La union,17,29,8,54
I (Ilocos Region),Philippine College of Science and Technology,69,29,6,104
I (Ilocos Region),PIMSAT Colleges-Dagupan,22,8,2,32
I (Ilocos Region),St. Columban's College,10,5,3,18
I (Ilocos Region),St. Louis College-San Fernando City,82,77,17,176
I (Ilocos Region),"St. Mary's College-Sta. Maria, Ilocos Sur",2,3,4,9
I (Ilocos Region),St. Paul College of Ilocos Sur,26,18,3,47
I (Ilocos Region),San Carlos College,18,17,19,54
I (Ilocos Region),Sea and Sky College,26,5,3,34
I (Ilocos Region),Union Christian College,26,34,18,78
I (Ilocos Region),University of Pangasinan,101,71,24,196
I (Ilocos Region),NJ Valdez Colleges Foundation,10,6,3,19
I (Ilocos Region),Virgen Milagrosa University Foundation,169,83,23,275
I (Ilocos Region),Metro-Dagupan Colleges,20,12,3,35
I (Ilocos Region),Pass College,25,8,6,39
I (Ilocos Region),AMA Computer College-Dagupan City,10,1,0,11
I (Ilocos Region),AMA Computer College-Laoag City,14,2,0,16
I (Ilocos Region),Lyceum Northwestern University,93,78,20,191
I (Ilocos Region),Macro Colleges,7,1,2,10
I (Ilocos Region),Sta. Veronica College,5,7,0,12
I (Ilocos Region),"STI College-San Fernando City, La Union",8,10,0,18
I (Ilocos Region),STI College-Dagupan City,14,7,0,21
I (Ilocos Region),AMA Computer College-La Union,7,5,0,12
I (Ilocos Region),Golden West Colleges,10,15,6,31
I (Ilocos Region),Lyceum Northwestern University-Urdaneta Campus,12,19,6,37
I (Ilocos Region),Data Center College of the Philippines-Vigan City,9,2,0,11
I (Ilocos Region),Colegio San Jose De Alaminos,8,11,0,19
I (Ilocos Region),Our Lady of Manaoag College,15,7,3,25
I (Ilocos Region),South Ilocandia College of Arts and Technology,9,6,1,16
I (Ilocos Region),La Union College of Science and Technology,1,6,2,9
I (Ilocos Region),Luzon College of Science and Technology-Urdaneta,2,8,6,16
I (Ilocos Region),Mystical Rose College of Science and Technology,4,7,7,18
I (Ilocos Region),St. Therese College Foundation,2,5,1,8
I (Ilocos Region),ABE International College of Business and Accountancy,17,7,0,24
I (Ilocos Region),La Finn's Scholastica,12,11,3,26
I (Ilocos Region),"Philippine Central College of Arts, Science and Technology",0,12,2,14
I (Ilocos Region),Panpacific University North Philippines-Tayug,37,14,7,58
I (Ilocos Region),Kingfisher School of Business and Finance,12,11,4,27
I (Ilocos Region),Northern Ilocandia College of Science and Technology,12,4,3,19
I (Ilocos Region),AIE College,0,19,2,21
I (Ilocos Region),St. Camillus College of Manaoag Foundation,6,11,4,21
I (Ilocos Region),International College for Excellence,9,19,2,30
I (Ilocos Region),Philippine College of Northwestern Luzon,15,22,4,41
I (Ilocos Region),Philippine Darakbang Theological College,6,5,2,13
I (Ilocos Region),St. John Bosco College of Northern Luzon,11,11,0,22
I (Ilocos Region),Rosales-Wesleyan Bible College,1,7,3,11
I (Ilocos Region),La Union Christian Comprehensive College,4,1,0,5
I (Ilocos Region),Immaculate Conception School of Theology,0,11,4,15
I (Ilocos Region),Polytechnic Colleges of Region I,6,11,1,18
I (Ilocos Region),WCC Aeronautical and Technological College,4,4,0,8
I (Ilocos Region),PIMSAT Colleges-San Carlos City,4,4,3,11
II (Cagayan Valley),Aldersgate College,30,33,5,68
II (Cagayan Valley),University of Cagayan Valley,93,93,40,226
II (Cagayan Valley),Eveland Christian College,7,3,0,10
II (Cagayan Valley),Fuzeko Polytechnic College,3,2,0,5
II (Cagayan Valley),Isabela Colleges,14,7,3,24
II (Cagayan Valley),University of La Salette,62,146,12,220
II (Cagayan Valley),Lyceum of Aparri,35,22,9,66
II (Cagayan Valley),Lyceum of Tuao,14,12,5,31
II (Cagayan Valley),Medical Colleges of Northern Philippines,11,20,0,31
II (Cagayan Valley),Northeastern College,60,12,4,76
II (Cagayan Valley),Northern Cagayan Colleges Foundation,8,4,3,15
II (Cagayan Valley),Our Lady of the Pillar College-Cauayan,39,46,4,89
II (Cagayan Valley),Patria Sable Corpus College,33,15,2,50
II (Cagayan Valley),PLT College,48,32,8,88
II (Cagayan Valley),Quezon Colleges of the North,9,1,0,10
II (Cagayan Valley),St. Anthony's College,13,6,1,20
II (Cagayan Valley),St. Dominic College of Batanes,17,15,0,32
II (Cagayan Valley),St. Ferdinand College-Ilagan,33,44,12,89
II (Cagayan Valley),St. Joseph's College of Baggao,8,10,3,21
II (Cagayan Valley),University of St. Louis-Tuguegarao,106,96,28,230
II (Cagayan Valley),St. Mary's University of Bayombong ,84,140,21,245
II (Cagayan Valley),St. Paul University Philippines,34,129,17,180
II (Cagayan Valley),Mallig Plains Colleges,13,14,14,41
II (Cagayan Valley),FL Vargas College-Tuguegarao,38,33,5,76
II (Cagayan Valley),Philippine Law Enforcement College,5,6,1,12
II (Cagayan Valley),Cagayan Valley Colleges of Quirino,5,5,2,12
II (Cagayan Valley),International School of Asia and the Pacific,35,22,2,59
II (Cagayan Valley),Isabela College of Arts and Technology,23,6,3,32
II (Cagayan Valley),AMA Computer College-Santiago City,7,7,1,15
II (Cagayan Valley),Cagayan Valley Computer and Information Technology College,15,16,1,32
II (Cagayan Valley),John Wesley College,11,5,0,16
II (Cagayan Valley),AMA Computer College-Tuguegarao City,8,1,0,9
II (Cagayan Valley),SISTECH College of Santiago City,7,4,1,12
II (Cagayan Valley),Santiago City Colleges,9,9,1,19
II (Cagayan Valley),St. Ferdinand College ,9,7,1,17
II (Cagayan Valley),MCN College,4,1,2,7
II (Cagayan Valley),Central College of the North,9,3,0,12
II (Cagayan Valley),FL Vargas College-Abulug,25,11,2,38
II (Cagayan Valley),Metropolitan School of Science and Technology,6,2,1,9
II (Cagayan Valley),STI College-Tuguegarao,5,4,0,9
II (Cagayan Valley),Sierra College,9,3,0,12
II (Cagayan Valley),University of Perpetual Help System,21,27,2,50
II (Cagayan Valley),Eastern Luzon Colleges,26,19,3,48
II (Cagayan Valley),STI College-Santiago City,6,5,1,12
II (Cagayan Valley),HG Baquiran College,13,6,2,21
II (Cagayan Valley),Infant Jesus Montessori School-College Department,2,11,1,14
II (Cagayan Valley),Maila Rosario Colleges,9,12,1,22
II (Cagayan Valley),Our Lady of the Pillar College-Cauayan San Manuel Branch,16,8,0,24
II (Cagayan Valley),Northeast Luzon Adventist College,3,5,1,9
III (Central Luzon),Angeles University Foundation,138,230,57,425
III (Central Luzon),Sto. Rosario Sapang Palay College,20,18,2,40
III (Central Luzon),Baliuag University,76,90,10,176
III (Central Luzon),Baliuag Maritime Foundation,18,4,1,23
III (Central Luzon),St. Patrick College,8,5,1,14
III (Central Luzon),Bataan Heroes Memorial College,25,4,0,29
III (Central Luzon),Camiling Colleges,2,9,3,14
III (Central Luzon),CIT Colleges of Paniqui Foundation,11,23,4,38
III (Central Luzon),Central Luzon Doctors' Hospital Educational Institution,40,45,3,88
III (Central Luzon),Central Luzon College of Technology-Olongapo,19,16,2,37
III (Central Luzon),Centro Escolar University,27,55,7,89
III (Central Luzon),Colegio De San Pascual Baylon,16,9,2,27
III (Central Luzon),College of the Holy Spirit of Tarlac,16,19,1,36
III (Central Luzon),College of the Immaculate Conception,33,37,29,99
III (Central Luzon),CORE Gateway College,29,2,0,31
III (Central Luzon),Columban College-Olongapo City,95,67,19,181
III (Central Luzon),College for Research and Technology-Cabanatuan City,15,13,2,30
III (Central Luzon),World Citi Colleges-Guimba Campus,11,4,3,18
III (Central Luzon),Divina Pastora College,6,6,0,12
III (Central Luzon),Dominican College of Tarlac,7,5,0,12
III (Central Luzon),Dr. Gloria D. Lacson Foundation Colleges-Nueva Ecija,13,12,9,34
III (Central Luzon),Dr. Yanga's Colleges,60,42,14,116
III (Central Luzon),East Central Colleges,18,22,1,41
III (Central Luzon),Ednor Colleges,6,1,0,7
III (Central Luzon),General De Jesus College,20,22,6,48
III (Central Luzon),The Good Samaritan Colleges,38,21,4,63
III (Central Luzon),Guagua National Colleges,27,32,5,64
III (Central Luzon),Holy Angel University,254,206,23,483
III (Central Luzon),Holy Cross College-Nueva Ecija,12,6,1,19
III (Central Luzon),Holy Cross College-Pampanga,9,32,2,43
III (Central Luzon),Immaculate Conception Major Seminary,3,13,7,23
III (Central Luzon),Interworld College of Technology Foundation-Tarlac,23,5,1,29
III (Central Luzon),Jesus Is Lord Colleges Foundation,7,18,0,25
III (Central Luzon),Jose C. Feliciano College,22,14,1,37
III (Central Luzon),Lourdes College of Bulacan,3,8,2,13
III (Central Luzon),Magsaysay Memorial College,11,5,1,17
III (Central Luzon),Manuel V. Gallego Foundation Colleges,27,10,12,49
III (Central Luzon),Maria Assumpta Seminary,5,10,0,15
III (Central Luzon),Megabyte College of Science and Technology-Guagua,3,4,0,7
III (Central Luzon),Metro Subic Colleges,13,11,4,28
III (Central Luzon),Meycauayan College,23,34,9,66
III (Central Luzon),Shepherds College,8,3,0,11
III (Central Luzon),Microcity Computer Colleges Foundation,15,2,0,17
III (Central Luzon),Midway Maritime Foundation,46,9,1,56
III (Central Luzon),Mondriaan Aura College,21,11,3,35
III (Central Luzon),Mother of Good Counsel Seminary,10,12,5,27
III (Central Luzon),Mt. Carmel College,10,10,4,24
III (Central Luzon),Nazarenus College and Hospital Foundation,11,11,7,29
III (Central Luzon),Nueva Ecija Colleges,17,12,2,31
III (Central Luzon),Carthel Science Educational Foundation,19,12,5,36
III (Central Luzon),Osias Colleges,15,11,8,34
III (Central Luzon),Our Lady of Peace College Seminary,10,14,5,29
III (Central Luzon),Pamantasan ng Araullo,98,36,17,151
III (Central Luzon),Pampanga Colleges,15,11,0,26
III (Central Luzon),La Consolacion University Philippines,29,54,16,99
III (Central Luzon),Republic Central Colleges,16,31,5,52
III (Central Luzon),St. Anthony College of Technology,10,6,4,20
III (Central Luzon),St. Mary's College of Meycauayan,7,30,1,38
III (Central Luzon),St. Paul University at San Miguel,11,8,0,19
III (Central Luzon),San Jose Christian Colleges,4,10,8,22
III (Central Luzon),Somascan Fathers Seminary,1,11,1,13
III (Central Luzon),STI College-Balanga,18,2,0,20
III (Central Luzon),STI College-City of Tarlac,13,5,0,18
III (Central Luzon),Systems Plus Computer College Foundation,44,60,6,110
III (Central Luzon),Tomas Del Rosario College,17,22,5,44
III (Central Luzon),University of the Assumption,34,62,7,103
III (Central Luzon),Virgen De Los Remedios College-Olongapo City,20,8,2,30
III (Central Luzon),Wesleyan University Philippines-Cabanatuan,149,82,14,245
III (Central Luzon),Interworld Colleges Foundation-Paniqui,22,4,2,28
III (Central Luzon),La Fortuna College,30,6,2,38
III (Central Luzon),STI College-City of San Fernando,33,10,0,43
III (Central Luzon),STI College-Angeles City,18,1,0,19
III (Central Luzon),STI College-Meycauayan,16,5,0,21
III (Central Luzon),STI College-Malolos,11,7,1,19
III (Central Luzon),United School of Science and Technology Colleges,30,12,3,45
III (Central Luzon),Concepcion Holy Cross College,16,5,4,25
III (Central Luzon),Northern Zambales College,12,11,2,25
III (Central Luzon),"Columban College-Sta. Cruz, Zambales",7,6,3,16
III (Central Luzon),College of St. Lawrence,20,10,1,31
III (Central Luzon),Fernandez College of Arts and Technology,42,28,3,73
III (Central Luzon),Micro Asia College of Science and Technology,11,9,0,20
III (Central Luzon),Sienna College of San Jose,22,9,2,33
III (Central Luzon),AMA Computer College-Cabanatuan City,15,8,0,23
III (Central Luzon),Comteq Computer and Business College,13,9,0,22
III (Central Luzon),Eastwoods Professional College of Science and Technology,24,7,0,31
III (Central Luzon),AMA Computer College-Malolos,13,2,0,15
III (Central Luzon),"AMA Computer College-San Fernando, Pampanga",10,12,0,22
III (Central Luzon),Dee Hwa Liong College Foundation,29,21,1,51
III (Central Luzon),Maritime Academy of Asia and the Pacific,32,34,5,71
III (Central Luzon),St. Joseph College of Bulacan,20,12,8,40
III (Central Luzon),Trinitas College,6,11,0,17
III (Central Luzon),AMA Computer College-Tarlac City,19,5,1,25
III (Central Luzon),Fundamental Baptist College for Asians,1,13,3,17
III (Central Luzon),St. Paul College of Technology,14,2,0,16
III (Central Luzon),ABE International College of Business and Economics,0,1,2,3
III (Central Luzon),AMA Computer College-Angeles City,17,0,1,18
III (Central Luzon),Asia Pacific College of Advanced Studies,35,14,1,50
III (Central Luzon),"College of Mary Immaculate of Pandi, Bulacan",7,7,1,15
III (Central Luzon),St. Mary's College of Baliuag,3,3,1,7
III (Central Luzon),St. Augustine Colleges Foundation,7,9,1,17
III (Central Luzon),St. Rose College Educational Foundation,0,7,2,9
III (Central Luzon),ABE International College of Business College,20,3,0,23
III (Central Luzon),AMA Computer College-Olongapo City,22,8,0,30
III (Central Luzon),La Concepcion College,13,12,6,31
III (Central Luzon),Colegio De San Gabriel Arcangel,0,42,16,58
III (Central Luzon),Mary the Queen College-Pampanga,37,24,6,67
III (Central Luzon),Ecumenical Christian College,9,11,1,21
III (Central Luzon),STI College-Sta. Maria,17,14,0,31
III (Central Luzon),STI College-Balagtas,25,6,1,32
III (Central Luzon),Lyceum of Subic Bay,45,16,2,63
III (Central Luzon),Santa Clara De Montefalco College,3,4,0,7
III (Central Luzon),First City Providential College,20,24,0,44
III (Central Luzon),College of the Most Holy Trinity,6,5,6,17
III (Central Luzon),Academia de San Lorenzo Dema Ala,9,13,4,26
III (Central Luzon),George Dewey Medical College,14,3,1,18
III (Central Luzon),St. Mary's Angel College of Pampanga,18,14,2,34
III (Central Luzon),St. Nicholas College of Business and Technology,47,14,1,62
III (Central Luzon),Dr. Gloria D. Lacson Foundation Colleges-Cabanatuan City,4,7,5,16
III (Central Luzon),College of Our Lady of Mt. Carmel-Pampanga,5,7,0,12
III (Central Luzon),"Central Luzon College of Science and Technology-City of San Fernando, Pampanga",11,11,2,24
III (Central Luzon),Colegio de San Juan de Letran ,26,11,7,44
III (Central Luzon),College of Subic Montessori,5,4,0,9
III (Central Luzon),STI College-Baliuag,25,6,1,32
III (Central Luzon),ACLC College of Meycauayan,11,1,3,15
III (Central Luzon),Colegio De Calumpit,4,6,3,13
III (Central Luzon),Gerona Junior College,8,10,3,21
III (Central Luzon),Holy Rosary Colleges Foundation of Calaba San Isidro Nueva Ecija,8,5,3,16
III (Central Luzon),Our Lady of Manaoag Montessori College,7,5,1,13
III (Central Luzon),Philippine Rehabilitation Institute Foundation,7,8,1,16
III (Central Luzon),St. Joseph's College of Balanga City,4,3,0,7
III (Central Luzon),Subic Bay College,6,18,4,28
III (Central Luzon),Mater Redemptoris College of San Jose City,10,11,11,32
III (Central Luzon),Megabyte College of Science and Technology-Florida,7,3,0,10
III (Central Luzon),Philippine Women's University Career Development and Continuing Education Center-Bataan,23,7,0,30
III (Central Luzon), Centro Colegio De Tarlac ,9,6,2,17
III (Central Luzon),Centro Colegio De Tarlac,21,2,0,23
III (Central Luzon),Philippine Women's University Career Development and Continuing Education Center-Tarlac,4,8,2,14
III (Central Luzon),La Verdad Christian College,10,6,2,18
III (Central Luzon),St. Benilde Center for Global Competence,6,12,1,19
III (Central Luzon),Marian College of Baliuag,9,6,1,16
III (Central Luzon),ACLC College of Balanga,11,0,0,11
III (Central Luzon),ACLC College of Baliuag,14,13,2,29
III (Central Luzon),Liceo de Pulilan Colleges,21,5,0,26
III (Central Luzon),ACLC College of Gapan,8,8,0,16
III (Central Luzon),Our Lady of Sacred Heart College of Guimba,15,6,2,23
III (Central Luzon),ACLC College of Apalit,7,8,1,16
III (Central Luzon),Tarlac Christian College,0,9,12,21
III (Central Luzon),St. Linus Online Institute-St. Linus University,6,9,2,17
III (Central Luzon),New Era University,7,8,2,17
III (Central Luzon),Santa Rita College of Pampanga,18,1,0,19
III (Central Luzon),Colegio de Sebastian,15,11,0,26
III (Central Luzon),Clark College of Science and Technology,28,2,0,30
III (Central Luzon),ACLC College of Mabalacat,0,7,0,7
III (Central Luzon),College of the Our Lady of Mercy of Pulilan,6,18,2,26
III (Central Luzon),Immaculate Conception International College of Arts and Technology,12,24,0,36
III (Central Luzon),Mount Carmel College-Baler,36,25,0,61
III (Central Luzon),Wesleyan University Philippines-Aurora,30,7,2,39
IV-A (CALABARZON),ACTS Computer College,7,10,2,19
IV-A (CALABARZON),Asia Pacific Nazarene Theological Seminary,0,6,9,15
IV-A (CALABARZON),Calauag Central College,16,8,2,26
IV-A (CALABARZON),Canossa College,26,15,3,44
IV-A (CALABARZON),Colegio de Los Banos,11,7,3,21
IV-A (CALABARZON),Colegio De San Juan De Letran-Calamba,44,158,18,220
IV-A (CALABARZON),Colegio de Sto. Nino de Cabuyao,5,2,1,8
IV-A (CALABARZON),De La Salle-Lipa,188,87,13,288
IV-A (CALABARZON),Deaf Evangelistic Alliance Foundation,8,0,0,8
IV-A (CALABARZON),Divine Word Seminary,2,11,11,24
IV-A (CALABARZON),De La Salle University-Dasmarinas,286,384,121,791
IV-A (CALABARZON),De La Salle Health Sciences Institute,198,139,19,356
IV-A (CALABARZON),Don Bosco College-Canlubang,29,11,2,42
IV-A (CALABARZON),Eastern Laguna Colleges,8,6,2,16
IV-A (CALABARZON),Eastern Quezon College,25,17,2,44
IV-A (CALABARZON),Eastern Tayabas College,5,1,0,6
IV-A (CALABARZON),Golden Gate Colleges,20,26,15,61
IV-A (CALABARZON),Harris Memorial College,12,17,3,32
IV-A (CALABARZON),Immaculada Concepcion Colleges-Soldier's Hills,8,7,3,18
IV-A (CALABARZON),Immaculate Conception College-Balayan,17,9,2,28
IV-A (CALABARZON),Imus Institute,13,31,5,49
IV-A (CALABARZON),ICCT Colleges,156,35,3,194
IV-A (CALABARZON),Dr. Francisco L. Calingasan Memorial Colleges Foundation,15,8,2,25
IV-A (CALABARZON),Laguna College,49,30,4,83
IV-A (CALABARZON),Laguna College of Business and Arts,41,39,24,104
IV-A (CALABARZON),Laguna Northwestern College,24,5,3,32
IV-A (CALABARZON),Leon Guinto Memorial College,18,12,3,33
IV-A (CALABARZON),Lipa City Colleges,43,72,0,115
IV-A (CALABARZON),Lyceum of the Philippines University-Batangas,129,138,53,320
IV-A (CALABARZON),Mabini Junior College,8,0,1,9
IV-A (CALABARZON),Manuel S. Enverga University Foundation-Lucena,85,121,15,221
IV-A (CALABARZON),Marcelino Fule Memorial College,20,7,1,28
IV-A (CALABARZON),Calayan Educational Foundation,33,31,11,75
IV-A (CALABARZON),Manuel S. Enverga University Foundation-Candelaria,34,29,1,64
IV-A (CALABARZON),Manuel S. Enverga University Foundation-Catanauan,15,10,0,25
IV-A (CALABARZON),National College of Business and Arts-Taytay,16,14,3,33
IV-A (CALABARZON),Northern Quezon College,43,13,3,59
IV-A (CALABARZON),Our Lady of Lourdes Seminary,12,5,3,20
IV-A (CALABARZON),University of Perpetual Help System-Laguna,76,92,19,187
IV-A (CALABARZON),University of Perpetual Help-Dr. Jose G. Tamayo Medical University,151,87,8,246
IV-A (CALABARZON),Adventist University of the Philippines,117,91,38,246
IV-A (CALABARZON),Presbyterian Theological Seminary,5,21,4,30
IV-A (CALABARZON),Quezonian Educational College,21,7,1,29
IV-A (CALABARZON),Rizal College of Taal,15,22,6,43
IV-A (CALABARZON),Rizal College of Laguna,13,7,2,22
IV-A (CALABARZON),Roosevelt College Cainta,22,30,14,66
IV-A (CALABARZON),Sacred Heart College ,32,69,9,110
IV-A (CALABARZON),St. Anne College of Lucena,60,51,7,118
IV-A (CALABARZON),St. Bridget College,16,19,2,37
IV-A (CALABARZON),St. Francis de Sales Major Seminary,16,1,0,17
IV-A (CALABARZON),St. Joseph College-Cavite City,18,13,2,33
IV-A (CALABARZON),St. Louis Anne Colleges,16,7,3,26
IV-A (CALABARZON),St. Michael's College of Laguna,25,32,11,68
IV-A (CALABARZON),St. Paul Seminary Foundation,1,7,2,10
IV-A (CALABARZON),St. Peter's College Seminary,10,13,3,26
IV-A (CALABARZON),San Antonio De Padua College,7,2,0,9
IV-A (CALABARZON),San Ildefonso College,13,1,2,16
IV-A (CALABARZON),San Pablo Colleges,34,38,10,82
IV-A (CALABARZON),San Pedro College of Business Administration,42,30,4,76
IV-A (CALABARZON),San Sebastian College-Recoletos de Cavite,65,49,6,120
IV-A (CALABARZON),Siena College of Taytay,36,36,6,78
IV-A (CALABARZON),Southeast Asia Interdisciplinary Development Institute,1,4,42,47
IV-A (CALABARZON),Tanauan Institute,10,9,4,23
IV-A (CALABARZON),Tayabas Western Academy,17,8,1,26
IV-A (CALABARZON),Tomas Claudio Memorial College,31,34,16,81
IV-A (CALABARZON),Unciano Colleges ,14,10,0,24
IV-A (CALABARZON),Union College of Laguna,25,25,7,57
IV-A (CALABARZON),Western Colleges,12,6,7,25
IV-A (CALABARZON),University of Batangas,19,17,11,47
IV-A (CALABARZON),STI College-Lucena ,19,6,1,26
IV-A (CALABARZON),University of Perpetual Help-Rizal Molino Campus ,39,44,3,86
IV-A (CALABARZON),STI College-San Pablo,19,1,0,20
IV-A (CALABARZON),STI Colleges of Luzon-Calamba Campus,26,12,0,38
IV-A (CALABARZON),Dominican College Sta. Rosa,5,12,3,20
IV-A (CALABARZON),St.s John and Paul Colleges,10,19,2,31
IV-A (CALABARZON),Sta. Teresa College,24,23,5,52
IV-A (CALABARZON),Southern Luzon College,8,3,0,11
IV-A (CALABARZON),STI College-Bacoor,17,10,1,28
IV-A (CALABARZON),STI College-Batangas,8,3,1,12
IV-A (CALABARZON),STI College-Sta. Cruz,16,11,0,27
IV-A (CALABARZON),STI College-Lipa,5,5,4,14
IV-A (CALABARZON),Trace College,3,12,1,16
IV-A (CALABARZON),STI eCollege Southwoods,23,13,1,37
IV-A (CALABARZON),AMA Computer College-Binan,13,8,0,21
IV-A (CALABARZON),Colegio De San Pedro,10,2,0,12
IV-A (CALABARZON),La Consolacion College-Binan,19,14,0,33
IV-A (CALABARZON),Laguna Science and Technology College,7,1,1,9
IV-A (CALABARZON),Mt. St. Aloysius Seminary,7,5,0,12
IV-A (CALABARZON),Cainta Catholic College,24,30,3,57
IV-A (CALABARZON),STI College Ortigas-Cainta,36,8,0,44
IV-A (CALABARZON),Maryhill College,12,17,4,33
IV-A (CALABARZON),University of Perpetual Help System-GMA Campus,27,35,7,69
IV-A (CALABARZON),Philippine Missionary Institute,12,10,2,24
IV-A (CALABARZON),Lemery Colleges,31,11,1,43
IV-A (CALABARZON),AMA Computer College-Sta.Cruz,19,6,0,25
IV-A (CALABARZON),Laguna Santiago Educational Foundation,11,2,0,13
IV-A (CALABARZON),Colegio San Agustin-Binan,10,10,1,21
IV-A (CALABARZON),AMA Computer College-East Rizal,13,15,2,30
IV-A (CALABARZON),Oblates of St. Joseph College of Philosophy,6,14,5,25
IV-A (CALABARZON),Inter-Global College Foundation ,8,13,1,22
IV-A (CALABARZON),University of Perpetual Help System-Dalta-Calamba,34,47,5,86
IV-A (CALABARZON),La Salle College-Antipolo,32,18,2,52
IV-A (CALABARZON),St. Alphonsus School of Theology,0,6,2,8
IV-A (CALABARZON),IETI College of Science and Technology,1,6,3,10
IV-A (CALABARZON),Adventist International Institute of Advanced Studies,2,8,30,40
IV-A (CALABARZON),Binangonan Catholic College,18,9,2,29
IV-A (CALABARZON),AMA Computer College-Dasmarinas,24,7,1,32
IV-A (CALABARZON),AMA Computer College-Batangas City,19,2,1,22
IV-A (CALABARZON),Professional Montessori College,0,5,0,5
IV-A (CALABARZON),Yaman Lahi Foundation-Emilio Aguinaldo College,44,55,10,109
IV-A (CALABARZON),Alitagtag College,3,6,1,10
IV-A (CALABARZON),AMA Computer College-Lipa,18,1,0,19
IV-A (CALABARZON),National College of Science and Technology,66,71,3,140
IV-A (CALABARZON),Rogationist College,34,15,2,51
IV-A (CALABARZON),St. John Colleges,20,9,5,34
IV-A (CALABARZON),AMA Computer College-Calamba,27,9,0,36
IV-A (CALABARZON),AMA Computer College-Lucena,20,7,2,29
IV-A (CALABARZON),Cavite West Point College,14,8,2,24
IV-A (CALABARZON),Our Lady of Assumption College System,0,5,3,8
IV-A (CALABARZON),Southern Philippines Institute of Science and Technology,12,10,2,24
IV-A (CALABARZON),St. Matthew College,5,5,1,11
IV-A (CALABARZON),World Citi Colleges-Quezon City,27,25,5,57
IV-A (CALABARZON),ABE International College of Business and Economics-Cainta,22,6,0,28
IV-A (CALABARZON),First Asia Institute of Technology and Humanities,84,50,3,137
IV-A (CALABARZON),Holy Child Jesus College,13,16,1,30
IV-A (CALABARZON),Lyceum of the Philippines-Laguna,64,40,5,109
IV-A (CALABARZON),St. Jude College,6,13,2,21
IV-A (CALABARZON),St. Francis Institute of Computer Studies,13,4,0,17
IV-A (CALABARZON),Lyceum of the Philippines-St. Cabrini College of Allied Medicine,1,13,0,14
IV-A (CALABARZON),Baptist Bible Seminary and Institute,9,5,2,16
IV-A (CALABARZON),Baptist Voice Bible College,9,0,0,9
IV-A (CALABARZON),"Philippine Cambridge School of Law, Arts, Sciences, Business Economics and Technology",15,7,11,33
IV-A (CALABARZON),Calamba Doctors' College,11,27,5,43
IV-A (CALABARZON),LNC Corinthian Center,26,5,1,32
IV-A (CALABARZON),STI College-Rosario,9,33,0,42
IV-A (CALABARZON),Unida Christian College,7,8,4,19
IV-A (CALABARZON),Columbus College,6,12,0,18
IV-A (CALABARZON),Casa Del Nino College,9,3,0,12
IV-A (CALABARZON),Mabini College of Batangas,5,3,1,9
IV-A (CALABARZON),STI College-Balayan,26,7,1,34
IV-A (CALABARZON),STI College-Sta. Rosa,70,15,2,87
IV-A (CALABARZON),La Consolacion College-Tanauan,27,14,2,43
IV-A (CALABARZON),AMA School of Medicine-East Rizal,9,12,1,22
IV-A (CALABARZON),DMMC Institute of Health Sciences,18,15,3,36
IV-A (CALABARZON),St. Francis of Assisi College-Cavite,7,8,1,16
IV-A (CALABARZON),Olivarez College-Tagaytay,8,36,3,47
IV-A (CALABARZON),St. Dominic College of Arts and Sciences of Cavite,24,65,12,101
IV-A (CALABARZON),Power School of Technology,8,7,0,15
IV-A (CALABARZON),De La Salle Leandro V. Locsin Campus-Canlubang,22,29,8,59
IV-A (CALABARZON),Philippine Women's University Career Development and Continuing Education Center-Calamba City,17,9,4,30
IV-A (CALABARZON),Christian College of Tanauan,17,13,0,30
IV-A (CALABARZON),Our Lady of the Most Holy Rosary Seminary,9,6,0,15
IV-A (CALABARZON),Batangas Eastern College,23,11,0,34
IV-A (CALABARZON),Ebenezer International Colleges,7,6,2,15
IV-A (CALABARZON),"Southdale International School of Science, Arts and Techology",8,16,1,25
IV-A (CALABARZON),ISHRM School System,17,10,0,27
IV-A (CALABARZON),STI College-Dasmarinas,32,6,0,38
IV-A (CALABARZON),Quezon Center for Research and Studies,10,6,1,17
IV-A (CALABARZON),St. Francis de Sales Theological Seminary,6,1,3,10
IV-A (CALABARZON), Informatics International College-Rizal ,19,0,1,20
IV-A (CALABARZON), PNTC Colleges ,39,3,3,45
IV-A (CALABARZON),Informatics International College-Rizal,13,16,7,36
IV-A (CALABARZON),PNTC Colleges,1,21,0,22
IV-A (CALABARZON),International Peace Leadership College,31,6,0,37
IV-A (CALABARZON),STI College-Tanauan,8,12,1,21
IV-A (CALABARZON),Philippine Women's University CDCEC-Sta. Cruz,6,4,4,14
IV-A (CALABARZON),Manuel S. Enverga University Foundation-San Antonio,10,5,2,17
IV-A (CALABARZON),All Nations College,9,20,7,36
IV-A (CALABARZON),International Christian College of Manila,8,2,0,10
IV-A (CALABARZON),International Evangelical Holiness College,23,6,2,31
IV-A (CALABARZON),Montessori Professional College-Imus,3,6,2,11
IV-A (CALABARZON),Teodoro M. Luansing College of Rosario,6,8,1,15
IV-A (CALABARZON),St. Constantine Institute of Science and Technology,19,7,3,29
IV-A (CALABARZON),St. Joseph College Amaya,1,9,5,15
IV-A (CALABARZON),CVE Colleges,9,5,1,15
IV-A (CALABARZON),San Sebastian College Recoletos-Canlubang,15,15,1,31
IV-A (CALABARZON),Westmead International School,48,29,19,96
IV-A (CALABARZON),Agoncillo College,18,5,1,24
IV-A (CALABARZON),Colegio de Amore,12,6,3,21
IV-A (CALABARZON),Far Eastern Polytechnic College,2,5,0,7
IV-A (CALABARZON),Immanuel College of Theology,0,9,2,11
IV-A (CALABARZON),Batangas College of Arts and Sciences,10,11,4,25
IV-A (CALABARZON),Malayan Colleges of Laguna,50,49,5,104
IV-A (CALABARZON),NYK-TDG Maritime Academy,14,3,1,18
IV-A (CALABARZON),Sumulong College of Arts and Sciences,9,17,4,30
IV-A (CALABARZON),St. Vincent College of Cabuyao,11,9,0,20
IV-A (CALABARZON),Our Lady of Fatima University-Antipolo,14,193,8,215
IV-A (CALABARZON),STI College-Tanay,26,15,3,44
IV-A (CALABARZON),Lyceum of the Philippines-Cavite,141,77,5,223
IV-A (CALABARZON),Asian Institute of Technology and Education Tiaong Campus,13,8,1,22
IV-A (CALABARZON),College of San Benildo-Rizal,1,6,1,8
IV-A (CALABARZON),STI College-Tagaytay,2,11,1,14
IV-A (CALABARZON),ISHRM School System-Dasmarinas,2,3,0,5
IV-A (CALABARZON),Far Eastern College-Silang,5,24,3,32
IV-A (CALABARZON),Abe International Business College-Quezon Province,11,6,0,17
IV-A (CALABARZON),Asia Pacific Christian College and Seminary,6,10,2,18
IV-A (CALABARZON),Asia Technological School of Science and Arts,25,13,1,39
IV-A (CALABARZON),CSTC Computer Systems Technology College,8,11,2,21
IV-A (CALABARZON),Evangelical Theological College of the Philippines-Luzon,1,11,0,12
IV-A (CALABARZON),Guinayangan College Foundation,11,1,1,13
IV-A (CALABARZON),Mary Help of Christians College-Salesian Sisters,4,5,0,9
IV-A (CALABARZON),The Bearer of Light and Wisdom Colleges,5,13,0,18
IV-A (CALABARZON),Young Ji College,5,3,5,13
V (Bicol Region),Aemilianum College,28,10,4,42
V (Bicol Region),Ago Medical and Educational Center,8,8,1,17
V (Bicol Region),Bicol Christian College of Medicine,14,2,0,16
V (Bicol Region),De Vera Institute of Technology,10,2,0,12
V (Bicol Region),Annunciation College of Bacon Sorsogon Unit,13,2,10,25
V (Bicol Region),Aquinas University of Legazpi,78,85,28,191
V (Bicol Region),Ateneo De Naga University,164,164,47,375
V (Bicol Region),Bicol College,53,50,20,123
V (Bicol Region),Bicol Merchant Marine College,16,6,0,22
V (Bicol Region),Camarines Norte College,10,9,1,20
V (Bicol Region),Catanduanes Colleges,45,12,3,60
V (Bicol Region),Ceguera Technological College,25,13,1,39
V (Bicol Region),St. Louise De Marillac College of Sorsogon,21,14,7,42
V (Bicol Region),Universidad de Sta. Isabel,0,2,2,4
V (Bicol Region),Computer Arts and Technological College,23,10,3,36
V (Bicol Region),Computer Communication Development Institute-Naga,15,5,0,20
V (Bicol Region),Computer Communication Development Institute-Goa,15,2,0,17
V (Bicol Region),Computer Communication Development Institute-Iriga City,5,9,1,15
V (Bicol Region),Daniel B. Pena Memorial College Foundation,36,6,8,50
V (Bicol Region),Divine Word College of Legazpi,47,76,18,141
V (Bicol Region),Felix O. Alfelor  Sr. Foundation College,9,4,2,15
V (Bicol Region),Alfelor Sr. Memorial College,20,8,2,30
V (Bicol Region),Fatima School of Science and Technology,6,0,0,6
V (Bicol Region),Holy Rosary Major Seminary,1,15,5,21
V (Bicol Region),Holy Trinity College,20,3,4,27
V (Bicol Region),Immaculate Conception College-Albay,4,30,1,35
V (Bicol Region),La Consolacion College-Iriga City,7,15,3,25
V (Bicol Region),La Consolacion College-Daet,16,16,0,32
V (Bicol Region),Liceo De Masbate,26,15,4,45
V (Bicol Region),Liceo de San Jacinto Foundation,18,3,4,25
V (Bicol Region),Mabini Colleges,44,22,11,77
V (Bicol Region),Mariners' Polytechnic Colleges Foundation-Baras,59,15,1,75
V (Bicol Region),Mariners' Polytechnic Colleges Foundation-Panganiban,30,12,4,46
V (Bicol Region),Mariners' Polytechnic Colleges Foundation-Legazpi,54,27,4,85
V (Bicol Region),Masbate College,47,18,7,72
V (Bicol Region),Mater Salutis College Seminary,3,13,1,17
V (Bicol Region),Naga College Foundation,54,68,25,147
V (Bicol Region),Osmena College,53,25,5,83
V (Bicol Region),Our Lady of Lourdes College Foundation,51,29,5,85
V (Bicol Region),Our Lady of Penafrancia Seminary,9,2,0,11
V (Bicol Region),Ovilla Technical College,5,6,2,13
V (Bicol Region),Partido College,25,11,15,51
V (Bicol Region),Perpetual Help Paramedical School,10,5,3,18
V (Bicol Region),Pili Capital College,12,6,0,18
V (Bicol Region),Polytechnic Institute of Tabaco,41,8,2,51
V (Bicol Region),Naga View Adventist College,14,11,4,29
V (Bicol Region),R.G. De Castro Colleges,25,7,5,37
V (Bicol Region),Republic Colleges of Guinobatan,7,10,8,25
V (Bicol Region),Southern Bicol Colleges,38,12,2,52
V (Bicol Region),Southern Luzon Institute,1,7,2,10
V (Bicol Region),Southern Masbate Roosevelt College,20,2,0,22
V (Bicol Region),Tabaco College,1,0,0,1
V (Bicol Region),Tanchuling College,17,5,0,22
V (Bicol Region),University of Northeastern Philippines,68,54,22,144
V (Bicol Region),University of Nueva Caceres,79,69,16,164
V (Bicol Region),University of St. Anthony,69,43,20,132
V (Bicol Region),Veritas College of Irosin,27,13,4,44
V (Bicol Region),Worldtech Resources Foundation-Naga City,11,5,0,16
V (Bicol Region),Worldtech Resources Foundation-Iriga City,11,5,0,16
V (Bicol Region),STI College-Legazpi,15,14,0,29
V (Bicol Region),Holy Family Center of Studies Foundation,4,10,3,17
V (Bicol Region),Holy Rosary Minor Seminary,2,16,4,22
V (Bicol Region),Lower Isarog Foundation Exponent,9,0,0,9
V (Bicol Region),Speed Computer College,18,2,1,21
V (Bicol Region),Zamora Memorial College,14,10,3,27
V (Bicol Region),Colegio De Sta. Monica of Polangui,9,3,2,14
V (Bicol Region),Computer Communication Development Institute-Legazpi City,19,0,0,19
V (Bicol Region),Sorsogon College of Criminology,13,5,1,19
V (Bicol Region),St. Peter Baptist College Foundation,8,3,1,12
V (Bicol Region),MABA Computer Oriented High School and College Laboratory and Tutorial Center Foundation,5,7,0,12
V (Bicol Region),AMA Computer College-Legazpi City,17,5,2,24
V (Bicol Region),Dr. Carlos S. Lanting College-Dr. Ruby Lanting Casaul Educational Foundation,15,5,2,22
V (Bicol Region),Programming Language Technique College,9,11,3,23
V (Bicol Region),Holy Trinity College Seminary,9,9,0,18
V (Bicol Region),AMA Computer College-Naga City,8,5,0,13
V (Bicol Region),Catanduanes Institute of Technology Foundation,13,3,1,17
V (Bicol Region),"Camarines Norte School of Laws, Arts and Sciences",25,7,0,32
V (Bicol Region),Solis Institute of Technology,10,8,2,20
V (Bicol Region),The Lewis College,18,5,1,24
V (Bicol Region),West Coast College,10,7,1,18
V (Bicol Region),Sta. Elena College-Camarines Norte,10,4,3,17
V (Bicol Region),Brentwood College of Asia International School,5,3,6,14
V (Bicol Region),Capalonga College,5,10,3,18
V (Bicol Region),Southern Luzon Technological College Foundation-Legazpi,22,7,3,32
V (Bicol Region),Our Lady of Salvation College,2,10,5,17
V (Bicol Region),Aeronautical Academy of the Philippines,12,2,0,14
V (Bicol Region),Computer Communication Development Institute-Sorsogon,12,7,1,20
V (Bicol Region),Amando Cope College,6,15,5,26
V (Bicol Region),Luis H. Dilanco Sr. Foundation College,10,0,0,10
V (Bicol Region),Regina Mondi College,10,5,0,15
V (Bicol Region),Siena College Tigaon,8,7,5,20
V (Bicol Region),Belen B. Francisco Foundation,7,12,1,20
V (Bicol Region),Estenias Science Foundation School,5,4,2,11
V (Bicol Region),Our Lady of the Most Holy Trinity College Seminary,3,8,1,12
V (Bicol Region),Philippine Computer Foundation College-Naga City,0,9,2,11
V (Bicol Region),Christian Polytechnic Institute of Catanduanes,5,1,4,10
V (Bicol Region),Forbes Colleges,16,9,0,25
V (Bicol Region),Jesus the Loving Shepherd Christian College,0,15,5,20
V (Bicol Region),ACLC College of Daet,11,3,0,14
V (Bicol Region),ACLC College of Sorsogon,6,5,1,12
V (Bicol Region),Infotech Development Systems Colleges,1,5,8,14
V (Bicol Region),Southern Luzon Technological College Foundation-Pilar,0,7,0,7
V (Bicol Region),Southern Luzon Technological College Foundation-Pioduran,7,6,1,14
V (Bicol Region),Philippine Computer Foundation College-Pili,0,2,1,3
V (Bicol Region),Belen B. Francisco Foundation-Albay,1,2,1,4
VI (Western Visayas),Aklan Catholic College,68,28,4,100
VI (Western Visayas),Aklan Polytechnic College,48,15,2,65
VI (Western Visayas),ACSI College Iloilo,10,1,0,11
VI (Western Visayas),Binalbagan Catholic College,34,21,4,59
VI (Western Visayas),Cabalum Western College,12,7,0,19
VI (Western Visayas),Cabarrus Catholic College,16,9,0,25
VI (Western Visayas),Central Negros College,13,3,3,19
VI (Western Visayas),Central Philippine Adventist College,39,30,6,75
VI (Western Visayas),Central Philippine University,367,212,45,624
VI (Western Visayas),Colegio de la Purisima Concepcion ,101,62,23,186
VI (Western Visayas),Colegio San Agustin-Bacolod,43,113,14,170
VI (Western Visayas),Colegio de San Jose-Jaro,11,17,1,29
VI (Western Visayas),Colegio De Sta. Rita,38,12,8,58
VI (Western Visayas),Colegio del Sagrado Corazon de Jesus,24,7,2,33
VI (Western Visayas),Fellowship Baptist College,39,33,2,74
VI (Western Visayas),Filamer Christian University,59,72,22,153
VI (Western Visayas),Fortress College,11,5,0,16
VI (Western Visayas),Garcia College of Technology,36,16,5,57
VI (Western Visayas),Iloilo Doctors' College,121,113,7,241
VI (Western Visayas),Iloilo Doctors' College of Medicine,86,0,2,88
VI (Western Visayas),John B. Lacson Colleges Foundation-Bacolod,52,78,10,140
VI (Western Visayas),John B. Lacson Foundation Maritime University-Molo,39,88,18,145
VI (Western Visayas),John B. Lacson Foundation Maritime University-Arevalo,25,56,25,106
VI (Western Visayas),Kabankalan Catholic College,28,15,3,46
VI (Western Visayas),La Consolacion College-Bacolod,70,76,14,160
VI (Western Visayas),La Consolacion College-Isabela,28,7,1,36
VI (Western Visayas),Mount Carmel College,23,14,1,38
VI (Western Visayas),St. Therese MTC Colleges-Tigbauan,28,18,0,46
VI (Western Visayas),North Negros College,6,12,3,21
VI (Western Visayas),Northwestern Visayan Colleges,45,38,7,90
VI (Western Visayas),Panay Technological College,13,2,1,16
VI (Western Visayas),Riverside College,33,93,7,133
VI (Western Visayas),St. Anthony College of Roxas City,24,17,2,43
VI (Western Visayas),St. Anthony's College-Antique,57,56,1,114
VI (Western Visayas),St. Gabriel College,18,27,0,45
VI (Western Visayas),St. Paul University of Iloilo,39,79,10,128
VI (Western Visayas),St. Vincent Ferrer Seminary,12,8,1,21
VI (Western Visayas),Sancta Maria Mater et Regina Seminarium,5,10,5,20
VI (Western Visayas),Silay Institute,9,16,4,29
VI (Western Visayas),Southern Negros College,3,10,1,14
VI (Western Visayas),Santo Nino Seminary,9,7,3,19
VI (Western Visayas),University of Iloilo,126,67,18,211
VI (Western Visayas),University of Negros Occidental-Recoletos,114,125,41,280
VI (Western Visayas),University of St. La Salle,222,246,49,517
VI (Western Visayas),University of San Agustin,249,185,35,469
VI (Western Visayas),VMA Global College,45,45,2,92
VI (Western Visayas),West Negros University,67,100,18,185
VI (Western Visayas),Western Institute of Technology,107,68,11,186
VI (Western Visayas),STI College-Iloilo,10,0,0,10
VI (Western Visayas),Pandan Bay Institute,9,5,1,15
VI (Western Visayas),STI College-Bacolod,6,3,0,9
VI (Western Visayas),Tanon College,6,11,3,20
VI (Western Visayas),AMA Computer College-Bacolod,12,1,1,14
VI (Western Visayas),AMA Computer College-Iloilo,8,5,0,13
VI (Western Visayas),Interface Computer College-Iloilo,19,6,0,25
VI (Western Visayas),College of St. John-Roxas,21,14,2,37
VI (Western Visayas),Mater Dei College-Silay City,14,10,3,27
VI (Western Visayas),St. Anne College of Iloilo,7,3,1,11
VI (Western Visayas),St. Therese MTC Colleges-La Fiesta,14,38,6,58
VI (Western Visayas),ABE International College of Business and Economics-Bacolod,14,5,0,19
VI (Western Visayas),Dominican College of Iloilo,14,5,1,20
VI (Western Visayas),Integrated Midwives Association of the Philippines Foundation School of Midwifery,3,5,0,8
VI (Western Visayas),St. Therese MTC Colleges-Magdalo,35,19,0,54
VI (Western Visayas),ABE International College of Business and Economics-Iloilo,24,10,0,34
VI (Western Visayas),STI College-Kalibo,27,4,0,31
VI (Western Visayas),Convention Baptist Bible College,8,10,2,20
VI (Western Visayas),Hercor College,27,12,17,56
VI (Western Visayas),Sacred Heart Seminary School-Bacolod,6,13,5,24
VI (Western Visayas),St. John Mary Vianney Seminary,5,15,1,21
VI (Western Visayas),Great Saviour College,11,9,1,21
VI (Western Visayas),St. Vincent College of Science and Technology,7,7,0,14
VI (Western Visayas),Southland College,2,16,0,18
VI (Western Visayas),CEDAR College,5,5,2,12
VI (Western Visayas),Advance Central College,14,8,1,23
VI (Western Visayas),GSEF College,3,5,2,10
VI (Western Visayas),ACLC College of Iloilo,4,8,0,12
VI (Western Visayas),Colegio de Sta. Ana de Victorias,9,4,2,15
VII (Central Visayas),AMA Computer College-Cebu City,13,0,0,13
VII (Central Visayas),Asian College of Technology,136,2,2,140
VII (Central Visayas),BIT International College-Siquijor,8,3,0,11
VII (Central Visayas),Baptist Theological College,15,0,9,24
VII (Central Visayas),Blessed Trinity College,22,8,0,30
VII (Central Visayas),BIT International College-Tagbilaran,52,18,9,79
VII (Central Visayas),Bohol Institute of Technology-Jagna,13,0,1,14
VII (Central Visayas),Bohol Institute of Technology-Talibon,8,4,2,14
VII (Central Visayas),Cebu Aeronautical Technical School,20,0,0,20
VII (Central Visayas),Cebu Doctor's University,250,4,16,270
VII (Central Visayas),Cebu Doctor's University College of Medicine,194,0,0,194
VII (Central Visayas),Cebu Eastern College,12,2,1,15
VII (Central Visayas),Cebu Institute of Medicine,111,15,1,127
VII (Central Visayas),Cebu Institute of Technology-University,245,8,30,283
VII (Central Visayas),Cebu Roosevelt Memorial College,87,0,6,93
VII (Central Visayas),St. Paul College Foundation,36,0,6,42
VII (Central Visayas),Cebu School of Midwifery,8,2,0,10
VII (Central Visayas),College of Technological Sciences-Cebu,22,1,1,24
VII (Central Visayas),Concord Technical Institute,12,0,2,14
VII (Central Visayas),Holy Name University,193,15,32,240
VII (Central Visayas),Diaz College,35,0,2,37
VII (Central Visayas),Felipe R. Verallo Memorial Foundation-Bogo,38,0,6,44
VII (Central Visayas),Foundation University,107,0,14,121
VII (Central Visayas),University of the Visayas-Gullas College of Medicine,112,0,0,112
VII (Central Visayas),Holy Trinity College,9,0,2,11
VII (Central Visayas),Immaculate Heart of Mary Seminary,22,0,0,22
VII (Central Visayas),Indiana School of Aeronautics,23,4,1,28
VII (Central Visayas),University of the Visayas-Mandaue Campus,15,0,3,18
VII (Central Visayas),Manto Memorial Foundation College,10,4,0,14
VII (Central Visayas),Mater Dei College-Bohol,63,1,7,71
VII (Central Visayas),Northern Cebu College,12,1,3,16
VII (Central Visayas),PMI Colleges-Bohol,44,16,2,62
VII (Central Visayas),St. Francis College-Guihulngan,27,7,2,36
VII (Central Visayas),St. Joseph College of Canlaon,30,0,1,31
VII (Central Visayas),St. Joseph Seminary College,4,13,1,18
VII (Central Visayas),St. Paul University Dumaguete,91,2,17,110
VII (Central Visayas),St. Theresa's College of Cebu,21,17,3,41
VII (Central Visayas),Salazar Colleges of Science and Institute of Technology,37,0,4,41
VII (Central Visayas),San Carlos Seminary College,9,0,7,16
VII (Central Visayas),Silliman University,203,279,49,531
VII (Central Visayas),Southwestern University,104,155,59,318
VII (Central Visayas),St. Catherines' College,44,0,1,45
VII (Central Visayas),Southwestern University-Matias H. Aznar Memorial College of Medicine,152,0,1,153
VII (Central Visayas),University of the Visayas-Gullas College Toledo Branch,65,0,7,72
VII (Central Visayas),University of Bohol,209,6,29,244
VII (Central Visayas),University of Cebu,149,2,9,160
VII (Central Visayas),University of San Carlos,715,1,100,816
VII (Central Visayas),University of San Jose-Recoletos,373,16,50,439
VII (Central Visayas),University of Southern Philippines Foundation,56,68,21,145
VII (Central Visayas),Quezon Memorial Institute of Siquijor,20,0,0,20
VII (Central Visayas),Velez College,103,39,2,144
VII (Central Visayas),Villaflores College,14,7,2,23
VII (Central Visayas),Batuan Colleges,2,6,1,9
VII (Central Visayas),Don Bosco Technology Center,27,18,5,50
VII (Central Visayas),Negros Maritime College Foundation,17,0,1,18
VII (Central Visayas),Royal Christian College,24,0,6,30
VII (Central Visayas),University of Cebu-Lapulapu and Mandaue,253,4,6,263
VII (Central Visayas),Asian College of Science and Technology-Dumaguete,35,1,0,36
VII (Central Visayas),De La Salle Andres Soriano Memorial College,15,0,3,18
VII (Central Visayas),Bantayan Southern Institute,26,0,0,26
VII (Central Visayas),Mount Moriah College,17,0,0,17
VII (Central Visayas),Presbyterian Theological College,9,6,5,20
VII (Central Visayas),STI College-Cebu City,17,0,0,17
VII (Central Visayas),Visayan Nazarene Bible College,21,0,0,21
VII (Central Visayas),Bohol Northern Star College,33,0,6,39
VII (Central Visayas),CBD College,11,0,2,13
VII (Central Visayas),Consolatrix College of Toledo City,36,0,4,40
VII (Central Visayas),Evangelical Theological College of the Philippines,20,4,0,24
VII (Central Visayas),St. Louise de Marillac College-Bogo,18,2,2,22
VII (Central Visayas),Seminaryo Mayor de San Carlos,0,10,3,13
VII (Central Visayas),Advanced Institute of Technology,7,0,0,7
VII (Central Visayas),Collegium Societatis Angeli Pacis,7,4,4,15
VII (Central Visayas),Centre for International Education Global Colleges,12,0,3,15
VII (Central Visayas),BIT International College-Carmen,7,2,0,9
VII (Central Visayas),AMA Computer College-Dumaguete City,13,4,0,17
VII (Central Visayas),Flight Dynamic School of Aeronautics,8,0,0,8
VII (Central Visayas),University of the Visayas-Gullas College Danao City Branch,15,7,2,24
VII (Central Visayas),Negros College,38,0,2,40
VII (Central Visayas),Benedicto College,34,0,5,39
VII (Central Visayas),Northeastern Cebu Colleges,20,0,1,21
VII (Central Visayas),St. Paul College Foundation-Mandaue,9,0,0,9
VII (Central Visayas),University of Cebu-Banilad,143,0,7,150
VII (Central Visayas),Bohol Northwestern College,8,3,0,11
VII (Central Visayas),Cebu Sacred Heart College,20,0,1,21
VII (Central Visayas),Larmen De Guia Memorial College,4,2,4,10
VII (Central Visayas),Interface Computer College,11,1,0,12
VII (Central Visayas),Mary's Children Formation College,7,6,4,17
VII (Central Visayas),Rogationist Seminary College-Cebu,12,1,4,17
VII (Central Visayas),Colegio de San Antonio de Padua,32,16,7,55
VII (Central Visayas),Cristal e-College,17,0,1,18
VII (Central Visayas),STI College-Tagbilaran,25,1,0,26
VII (Central Visayas),University of the Visayas-Gullas College Minglanilla Campus,7,3,0,10
VII (Central Visayas),Bohol Wisdom School,20,1,2,23
VII (Central Visayas),Central Philippine Bible College,12,0,1,13
VII (Central Visayas),Cebu Mary Immaculate College,19,0,0,19
VII (Central Visayas),ACLC College of Mandaue,62,2,1,65
VII (Central Visayas),Immanuel Bible College,26,0,1,27
VII (Central Visayas),Trade-Tech International Science Institute,16,8,1,25
VII (Central Visayas),Cristal e-College-Panglao Campus,60,1,1,62
VII (Central Visayas),Professional Academy of the Philippines,34,0,5,39
VII (Central Visayas),La Consolacion College-Liloan,17,0,1,18
VII (Central Visayas),Sto. Tomas College,16,0,2,18
VII (Central Visayas),Microsystem International Institute of Technology,9,2,0,11
VII (Central Visayas),Metro Dumaguete College,28,0,1,29
VII (Central Visayas),University of The Visayas-Dalaguete Campus,17,5,2,24
VII (Central Visayas),Maxino College,5,2,7,14
VII (Central Visayas),La Consolacion College-Bais,26,14,1,41
VII (Central Visayas),Lyceum of Cebu,18,2,3,23
VII (Central Visayas),Golden Success College,20,2,4,26
VII (Central Visayas),ACLC College of Tagbilaran,10,0,0,10
VII (Central Visayas),St. Cecilia's College-Cebu,12,7,4,23
VII (Central Visayas),NISSI Academy ,0,4,1,5
VII (Central Visayas),St. Louis College-Cebu ,17,2,1,20
VII (Central Visayas),Mary Our Help Technical Institute for Women,13,5,1,19
VII (Central Visayas),Carmelite College-Siquijor ,7,1,2,10
VII (Central Visayas),Rosemont Hills Montessori Academy ,10,0,2,12
VII (Central Visayas),I.K.O.N. College ,9,1,0,10
VII (Central Visayas),Tabor Hills College,11,0,0,11
VII (Central Visayas),Rizwoods Colleges,10,0,2,12
VIII (Eastern Visayas),Asian Development Foundation College,66,0,10,76
VIII (Eastern Visayas),Christ the King College-Calbayog City,40,3,2,45
VIII (Eastern Visayas),The College of Maasin,61,21,1,83
VIII (Eastern Visayas),Dr. V. Orestes Romualdez Educational Foundation,16,0,0,16
VIII (Eastern Visayas),Dona Remedios Trinidad Medical Foundation,84,43,6,133
VIII (Eastern Visayas),Franciscan College of the Immaculate Conception,37,1,1,39
VIII (Eastern Visayas),Holy Infant College,42,0,6,48
VIII (Eastern Visayas),Leyte Colleges,61,25,8,94
VIII (Eastern Visayas),Northern Leyte College,15,0,0,15
VIII (Eastern Visayas),St. Mary's College of Catbalogan,7,31,1,39
VIII (Eastern Visayas),Sacred Heart Seminary,8,0,7,15
VIII (Eastern Visayas),St. Francis College,15,2,1,18
VIII (Eastern Visayas),St. Joseph College,58,54,7,119
VIII (Eastern Visayas),St. Mary's College of Borongan,10,18,5,33
VIII (Eastern Visayas),St. Peter's College of Ormoc,13,12,3,28
VIII (Eastern Visayas),St. Vincent De Paul College Seminary,4,9,0,13
VIII (Eastern Visayas),Samar College,54,17,7,78
VIII (Eastern Visayas),Colegio De San Lorenzo Ruiz De Manila of Northern Samar,84,11,9,104
VIII (Eastern Visayas),St. James College of Padre Burgos,13,2,1,16
VIII (Eastern Visayas),St. Paul School of Business and Law,24,18,3,45
VIII (Eastern Visayas),St. Thomas Aquinas College,23,6,1,30
VIII (Eastern Visayas),Sto. Nino College of Ormoc,26,11,3,40
VIII (Eastern Visayas),Western Leyte College of Ormoc City,54,40,4,98
VIII (Eastern Visayas),J.E. Mondejar Computer College,36,0,0,36
VIII (Eastern Visayas),Mater Divinae Gratiae College,16,0,0,16
VIII (Eastern Visayas),Our Lady of Mercy College,15,4,1,20
VIII (Eastern Visayas),Bato Institute of Science and Technology,12,9,1,22
VIII (Eastern Visayas),Holy Cross College of Carigara,30,0,2,32
VIII (Eastern Visayas),STI College-Tacloban,13,6,0,19
VIII (Eastern Visayas),Jose Navarro Polytechnic College,13,3,0,16
VIII (Eastern Visayas),STI College-Ormoc,17,10,0,27
VIII (Eastern Visayas),Eastern Visayas Central Colleges,24,0,2,26
VIII (Eastern Visayas),AMA Computer College-Tacloban City,11,2,1,14
VIII (Eastern Visayas),St. Scholastica's College Tacloban,18,26,6,50
VIII (Eastern Visayas),ABE International College of Business and Economics-Tacloban City,9,7,2,18
VIII (Eastern Visayas),St. Michael College-Hindang Campus,16,15,2,33
VIII (Eastern Visayas),Holy Spirit College Foundation of Leyte,16,0,1,17
VIII (Eastern Visayas),MLG College of Learning,13,0,1,14
VIII (Eastern Visayas),Northern Samar Colleges,14,7,10,31
VIII (Eastern Visayas),"Asia College of Advance Studies In Arts, Sciences and Technology",21,0,4,25
VIII (Eastern Visayas),Leyte School of Professionals,5,0,1,6
VIII (Eastern Visayas),St. John the Evangelist School of Theology,9,9,18,36
VIII (Eastern Visayas),Colegio De San Juan Samar,20,1,3,24
VIII (Eastern Visayas),Colegio De Sta. Lourdes of Leyte Foundation,13,18,0,31
VIII (Eastern Visayas),East Pacific Computer College,9,3,0,12
VIII (Eastern Visayas),Colegio de la Salle Fondation de Tacloban,14,1,0,15
VIII (Eastern Visayas),Holy Virgin of Salvacion Foundation College,9,2,6,17
VIII (Eastern Visayas),San Lorenzo Ruiz College of Ormoc,15,14,2,31
VIII (Eastern Visayas),ACLC College of Tacloban City,41,0,0,41
VIII (Eastern Visayas),Calbiga Western Samar College,12,3,2,17
VIII (Eastern Visayas),ACLC College of Ormoc,10,0,0,10
VIII (Eastern Visayas),Tan Ting Bing Memorial Colleges Foundation,15,3,0,18
VIII (Eastern Visayas),Global School for Technological Studies,22,0,2,24
VIII (Eastern Visayas),Visayas Christian Institute of Technology,0,4,4,8
IX (Zamboanga Peninsula),Andres Bonifacio College,59,44,3,106
IX (Zamboanga Peninsula),Ateneo De Zamboanga University,125,123,22,270
IX (Zamboanga Peninsula),Brent Hospital and Colleges,46,35,0,81
IX (Zamboanga Peninsula),Claret College of Isabela,58,9,0,67
IX (Zamboanga Peninsula),Dipolog Medical Center College Foundation,44,32,3,79
IX (Zamboanga Peninsula),Dr. Aurelio Mendoza Memorial College,31,9,5,45
IX (Zamboanga Peninsula),Immaculate Conception Archdiocesan School,12,9,0,21
IX (Zamboanga Peninsula),Juan S. Alano Memorial School,8,4,0,12
IX (Zamboanga Peninsula),Marian College,21,9,2,32
IX (Zamboanga Peninsula),Mein College,17,9,2,28
IX (Zamboanga Peninsula),Blancia College Foundation,15,7,1,23
IX (Zamboanga Peninsula),Philippine Advent College,34,7,3,44
IX (Zamboanga Peninsula),Pilar College,48,35,4,87
IX (Zamboanga Peninsula),Rizal Memorial Institute of Dapitan City,12,9,2,23
IX (Zamboanga Peninsula),St. Columban College,43,40,7,90
IX (Zamboanga Peninsula),St. John Hospital and Colleges,10,8,0,18
IX (Zamboanga Peninsula),St. Joseph College,24,20,2,46
IX (Zamboanga Peninsula),St. Vincent's College,53,48,14,115
IX (Zamboanga Peninsula),St. Estanislao Kostka College,10,4,2,16
IX (Zamboanga Peninsula),Southern Mindanao College-Agro Tech,2,0,0,2
IX (Zamboanga Peninsula),Southern City Colleges,34,13,2,49
IX (Zamboanga Peninsula),Southern Mindanao Colleges,54,55,18,127
IX (Zamboanga Peninsula),Universidad de Zamboanga,69,147,54,270
IX (Zamboanga Peninsula),STI College-Zamboanga,27,2,1,30
IX (Zamboanga Peninsula),Medina College-Pagadian,9,23,0,32
IX (Zamboanga Peninsula),Zamboanga Del Sur Maritime Institute of Technology,47,8,1,56
IX (Zamboanga Peninsula),Pagadian Capitol College,34,7,1,42
IX (Zamboanga Peninsula),Aurora Pioneer Memorial College,27,12,3,42
IX (Zamboanga Peninsula),Dipolog City Institute of Technology,12,11,5,28
IX (Zamboanga Peninsula),Ebenezer Bible College and Seminary,15,5,3,23
IX (Zamboanga Peninsula),St. Mary's College of Labason,17,9,3,29
IX (Zamboanga Peninsula),AMA Computer College-Zamboanga City,24,0,0,24
IX (Zamboanga Peninsula),Colegio De San Francisco Javier,20,8,1,29
IX (Zamboanga Peninsula),Richmond Montessori College,7,1,0,8
IX (Zamboanga Peninsula),Computer Technologies Institute of Zamboanga City,4,6,2,12
IX (Zamboanga Peninsula),Computer Technologies Institute of Basilan,6,4,0,10
IX (Zamboanga Peninsula),HMIJ Foundation Philippine Islamic College,14,4,2,20
IX (Zamboanga Peninsula),Eastern Mindanao College of Technology,18,7,1,26
IX (Zamboanga Peninsula),Universidad de Zamboanga-Ipil,31,9,2,42
IX (Zamboanga Peninsula),Medina College-Ipil,12,8,1,21
IX (Zamboanga Peninsula),Southwestern Philippines Foundation College,3,2,0,5
IX (Zamboanga Peninsula),Philippine Technological and Marine Sciences-Zamboanga del Sur,5,2,0,7
IX (Zamboanga Peninsula),Western Mindanao Foundation College,8,2,3,13
IX (Zamboanga Peninsula),Southern Peninsula College,15,4,2,21
IX (Zamboanga Peninsula),Lucan Polytechnic College,10,7,4,21
IX (Zamboanga Peninsula),Sibugay Technical Institute,8,32,1,41
IX (Zamboanga Peninsula),Mendero College,1,8,0,9
IX (Zamboanga Peninsula),Aim High College,1,8,0,9
IX (Zamboanga Peninsula),Ave Maria College,12,1,3,16
IX (Zamboanga Peninsula),Hyrons College Philippines,8,5,2,15
IX (Zamboanga Peninsula),Nuevo Zamboanga College,18,2,3,23
IX (Zamboanga Peninsula),Pastor Bonus Seminary,6,6,7,19
IX (Zamboanga Peninsula),Philippine Advent College-Salug,10,1,2,13
IX (Zamboanga Peninsula),Yllana Bay View College,18,4,0,22
X (Northern Mindanao),Alemarz School of Science and Technology Foundation,5,6,1,12
X (Northern Mindanao),Blessed Mother College,20,6,2,28
X (Northern Mindanao),Capitol University,32,97,34,163
X (Northern Mindanao),Cagayan De Oro College,101,75,14,190
X (Northern Mindanao),Christ the King College,36,21,2,59
X (Northern Mindanao),Colegio De Santo Nino De Jasaan,12,3,1,16
X (Northern Mindanao),Fatima College of Camiguin,19,20,3,42
X (Northern Mindanao),Gingoog City Junior College,29,7,2,38
X (Northern Mindanao),Gingoog Christian College,14,8,1,23
X (Northern Mindanao),Guevarra Institute of Technology,8,0,0,8
X (Northern Mindanao),La Salle University,76,79,7,162
X (Northern Mindanao),Liceo De Cagayan University,142,169,41,352
X (Northern Mindanao),Lourdes College,57,48,15,120
X (Northern Mindanao),Medina College,33,24,2,59
X (Northern Mindanao),Medina Foundation College,11,2,2,15
X (Northern Mindanao),Mindanao Arts and Technological Institute,11,7,0,18
X (Northern Mindanao),Misamis Institute of Technology,34,4,0,38
X (Northern Mindanao),Misamis University-Ozamis City,90,119,20,229
X (Northern Mindanao),Misamis University-Oroquieta City,23,9,5,37
X (Northern Mindanao),Mountain View College,42,58,15,115
X (Northern Mindanao),Golden Heritage Polytechnic College,17,18,4,39
X (Northern Mindanao),Northwestern Mindanao Christian Colleges,10,3,0,13
X (Northern Mindanao),Philippine College Foundation,10,10,6,26
X (Northern Mindanao),Pilgrim Christian College,36,29,7,72
X (Northern Mindanao),Quezon Institute of Technology,5,12,0,17
X (Northern Mindanao),Sacred Heart College of Calamba,18,7,0,25
X (Northern Mindanao),St. John Vianney Theological Seminary,9,5,6,20
X (Northern Mindanao),St. Peter's College of Balingasag,18,8,6,32
X (Northern Mindanao),St. Rita's College of Balingasag,34,7,2,43
X (Northern Mindanao),San Agustin Institute of Technology,32,11,4,47
X (Northern Mindanao),San Isidro College,32,26,6,64
X (Northern Mindanao),Southern Bukidnon Foundation Academy,6,6,1,13
X (Northern Mindanao),Southern Capital Colleges,15,3,1,19
X (Northern Mindanao),Southern De Oro Philippines College,29,16,3,48
X (Northern Mindanao),Stella Maris College,12,12,1,25
X (Northern Mindanao),Valencia Colleges,16,20,2,38
X (Northern Mindanao),Xavier University,299,211,55,565
X (Northern Mindanao),STI Colleges of Mindanao,28,6,0,34
X (Northern Mindanao),AMA Computer College,12,2,0,14
X (Northern Mindanao),Philippine Computer College,22,3,0,25
X (Northern Mindanao),Roman C. Villalon Memorial Colleges Foundation,13,11,2,26
X (Northern Mindanao),Oro Bible College,4,6,1,11
X (Northern Mindanao),Dr. Solomon U. Molina College,3,13,2,18
X (Northern Mindanao),Adventist Technological Institute,11,2,0,13
X (Northern Mindanao),Southern Maramag Colleges,9,0,1,10
X (Northern Mindanao),ACLC College of Bukidnon,4,12,0,16
X (Northern Mindanao),IBA College of Mindanao,16,13,7,36
X (Northern Mindanao),Misamis Oriental Institute of Science and Technology,25,8,2,35
X (Northern Mindanao),St. Mary's Maternity and Children's Hospital School,5,7,0,12
X (Northern Mindanao),The New El Salvador Colleges,6,10,1,17
X (Northern Mindanao),Our Lady of Triumph Institute of Technology,19,2,1,22
X (Northern Mindanao),Vineyard International Polytechnic College,4,2,0,6
X (Northern Mindanao),Northwestern Mindanao Institute of Technology,5,6,0,11
X (Northern Mindanao),North Central Mindanao Colleges,51,19,0,70
X (Northern Mindanao),Iligan Capitol College,19,15,5,39
X (Northern Mindanao),ICTI Polytechnic College,27,1,0,28
X (Northern Mindanao),Iligan Medical Center College,39,21,10,70
X (Northern Mindanao),Mindanao Sanitarium and Hospital College,23,37,8,68
X (Northern Mindanao),St. Michael's College,60,55,19,134
X (Northern Mindanao),St. Peter's College-lligan City,68,26,13,107
X (Northern Mindanao),Santa Monica Institute of Technology,9,2,3,14
X (Northern Mindanao),Lyceum of Iligan Foundation,25,19,0,44
X (Northern Mindanao),Christ The King College De Maranding,23,11,1,35
X (Northern Mindanao),Lanao School of Science and Technology,14,14,2,30
X (Northern Mindanao),Masters Technological Institute of Mindanao,10,3,3,16
X (Northern Mindanao),Picardal Institute of Science and Technology,6,3,1,10
XI (Davao Region),Agro-Industrial Foundation College of the Philippines-Davao ,29,0,0,29
XI (Davao Region),AMA Computer College-Davao,9,26,1,36
XI (Davao Region),Arriesgado College Foundation,26,16,2,44
XI (Davao Region),Assumption College of Nabunturan,19,24,2,45
XI (Davao Region),Ateneo De Davao University,144,223,84,451
XI (Davao Region),Brokenshire College,51,65,8,124
XI (Davao Region),Cor Jesu College,57,48,8,113
XI (Davao Region),Davao Central College,18,31,7,56
XI (Davao Region),Davao Doctors College,44,56,3,103
XI (Davao Region),Davao Medical School Foundation College,319,46,4,369
XI (Davao Region),DMMA College of Southern Philippines,81,25,3,109
XI (Davao Region),Fabie School of Midwifery,8,1,0,9
XI (Davao Region),Ford Academy of the Arts,11,0,0,11
XI (Davao Region),General Baptist Bible College,6,3,0,9
XI (Davao Region),Holy Cross College of Calinan,17,15,4,36
XI (Davao Region),Holy Cross of Bansalan College,20,15,3,38
XI (Davao Region),Holy Cross of Davao College,147,186,34,367
XI (Davao Region),Liceo De Davao,1,9,5,15
XI (Davao Region),Mati Polytechnic College,17,5,0,22
XI (Davao Region),MATS College of Technology,103,11,3,117
XI (Davao Region),Mindanao Medical Foundation College,29,8,1,38
XI (Davao Region),North Davao College-Tagum Foundation,8,9,0,17
XI (Davao Region),North Davao Colleges-Panabo,11,10,1,22
XI (Davao Region),Philippine Women's College of Davao,29,33,2,64
XI (Davao Region),Polytechnic College of Davao del Sur,34,17,7,58
XI (Davao Region),Queen of Apostles College Seminary,6,13,1,20
XI (Davao Region),Rizal Memorial Colleges,25,27,10,62
XI (Davao Region),St. Francis Xavier College Seminary,4,7,6,17
XI (Davao Region),St. Mary's College of Tagum,53,45,2,100
XI (Davao Region),St. Peter's College of Toril,15,43,10,68
XI (Davao Region),San Pedro College,150,120,6,276
XI (Davao Region),Serapion C. Basalo Memorial Foundation College,7,2,1,10
XI (Davao Region),Southeastern College of Padada,10,10,3,23
XI (Davao Region),Southern Philippine Adventist College,28,17,6,51
XI (Davao Region),Tecarro College Foundation,7,6,0,13
XI (Davao Region),UM Bansalan College,8,10,0,18
XI (Davao Region),UM Digos College,26,32,6,64
XI (Davao Region),UM Guianga College,5,11,1,17
XI (Davao Region),UM Panabo College,11,13,6,30
XI (Davao Region),UM Tagum College,68,90,29,187
XI (Davao Region),University of Mindanao,141,250,64,455
XI (Davao Region),University of the Immaculate Conception,70,94,13,177
XI (Davao Region),Joji Ilagan Career Center Foundation,7,15,1,23
XI (Davao Region),St. Francis Xavier Regional Major Seminary of Mindanao,0,14,3,17
XI (Davao Region),Assumption College of Davao,28,15,0,43
XI (Davao Region),Interface Computer College,2,9,0,11
XI (Davao Region),UM Penaplata College,2,12,2,16
XI (Davao Region),Aces Tagum College,14,18,0,32
XI (Davao Region),John Paul II College of Davao,37,36,3,76
XI (Davao Region),Philippine College of Technology,19,19,4,42
XI (Davao Region),Mindanao Kokosai Daigaku,3,12,6,21
XI (Davao Region),Holy Child School of Davao,18,18,1,37
XI (Davao Region),Mati Doctors College,33,6,3,42
XI (Davao Region),Southern Philippines Baptist Theological Seminary,11,2,1,14
XI (Davao Region),STI College-Davao,22,11,1,34
XI (Davao Region),Jose Maria College,38,27,6,71
XI (Davao Region),Estela College,11,6,0,17
XI (Davao Region),Christian Colleges of Southeast Asia,13,19,4,36
XI (Davao Region),Davao Winchester Colleges,10,6,2,18
XI (Davao Region),Legacy College of Compostela,6,19,5,30
XI (Davao Region),Holy Cross of Davao College-Babak,10,12,3,25
XI (Davao Region),St. Mary's College Baganga,12,8,4,24
XI (Davao Region),Intercity College of Science and Technology,9,9,2,20
XI (Davao Region),Holy Cross Academy of Sasa,1,7,2,10
XI (Davao Region),Laak Institute Foundation,10,7,2,19
XI (Davao Region),Tagum Doctors College,12,7,0,19
XI (Davao Region),Gabriel Taborin College of Davao Foundation,12,10,6,28
XI (Davao Region),ACES PolytechnicCollege,16,13,0,29
XI (Davao Region),Davao Vision Colleges,5,6,1,12
XI (Davao Region),East West Colleges,6,3,0,9
XI (Davao Region),St. Thomas More School of Law and Business,10,17,1,28
XI (Davao Region),ACQ College of Ministries,2,18,5,25
XI (Davao Region),Christian Academy in Davao Oriental Technological Colleges,10,3,1,14
XI (Davao Region),Koinonia Theological Seminary Foundation,0,4,6,10
XI (Davao Region),Jobs Academy,6,12,1,19
XI (Davao Region),Mt. Apo Science Foundation College,4,1,0,5
XI (Davao Region),Northlink Technological College,11,7,0,18
XI (Davao Region),ACLC College of Tagum City,6,5,0,11
XI (Davao Region),Tagum City College of Science and Technology Foundation,8,7,0,15
XII (SOCCSKSARGEN),Nikki Louise College,8,0,2,10
XII (SOCCSKSARGEN),St. Alexius College,29,47,7,83
XII (SOCCSKSARGEN),Edenton Mission College,15,6,0,21
XII (SOCCSKSARGEN),Gensantos Foundation College,130,18,3,151
XII (SOCCSKSARGEN),Holy Trinity College of General Santos City,58,37,9,104
XII (SOCCSKSARGEN),King's College of Marbel,19,15,3,37
XII (SOCCSKSARGEN),Mindanao Polytechnic College,87,31,3,121
XII (SOCCSKSARGEN),Notre Dame of Dadiangas University,70,115,12,197
XII (SOCCSKSARGEN),Notre Dame of Marbel University,79,104,16,199
XII (SOCCSKSARGEN),Schola de San Jose,2,3,2,7
XII (SOCCSKSARGEN),Ramon Magsaysay Memorial Colleges,49,64,8,121
XII (SOCCSKSARGEN),Santa Cruz Mission School,7,3,0,10
XII (SOCCSKSARGEN),STI College-General Santos City,8,18,1,27
XII (SOCCSKSARGEN),Green Valley College Foundation,26,13,0,39
XII (SOCCSKSARGEN),Marbel School of Science and Technology,7,4,0,11
XII (SOCCSKSARGEN),AMA Computer College-General Santos City,8,2,0,10
XII (SOCCSKSARGEN),Central Mindanao Colleges,48,23,5,76
XII (SOCCSKSARGEN),Regency Polytechnic College,22,14,2,38
XII (SOCCSKSARGEN),Cotabato Medical Foundation College,1,23,0,24
XII (SOCCSKSARGEN),De La Vida College,13,3,0,16
XII (SOCCSKSARGEN),Dr. Domingo B. Tamondong Memorial School,14,0,0,14
XII (SOCCSKSARGEN),Dr. P. Ocampo Colleges,20,8,0,28
XII (SOCCSKSARGEN),Headstart College of Cotabato,10,3,0,13
XII (SOCCSKSARGEN),King's College of Isulan,4,3,1,8
XII (SOCCSKSARGEN),Lebak Family Doctors' School of Midwifery,13,0,0,13
XII (SOCCSKSARGEN),Mindanao Capitol College,5,12,2,19
XII (SOCCSKSARGEN),Colegio de Kidapawan,51,13,2,66
XII (SOCCSKSARGEN),Northern Cotabato Colleges Foundation,6,2,0,8
XII (SOCCSKSARGEN),Notre Dame Center for Catechesis,3,7,0,10
XII (SOCCSKSARGEN),Notre Dame Hospital and School of Midwifery,10,2,0,12
XII (SOCCSKSARGEN),Notre Dame of Kidapawan College,41,60,8,109
XII (SOCCSKSARGEN),Notre Dame of Midsayap College,42,48,6,96
XII (SOCCSKSARGEN),Notre Dame of Salaman College,21,8,0,29
XII (SOCCSKSARGEN),Notre Dame of Tacurong College,36,30,5,71
XII (SOCCSKSARGEN),Notre Dame University,125,87,24,236
XII (SOCCSKSARGEN),Quezon Colleges of Southern Philippines,20,2,0,22
XII (SOCCSKSARGEN),St. Benedict College of Cotabato,17,11,2,30
XII (SOCCSKSARGEN),St. Luke's Institute,17,6,0,23
XII (SOCCSKSARGEN),Senator Ninoy Aquino College Foundation,14,4,0,18
XII (SOCCSKSARGEN),Shariff Kabunsuan College,6,8,1,15
XII (SOCCSKSARGEN),Southern Baptist College,32,17,5,54
XII (SOCCSKSARGEN),Southern Christian College,32,29,3,64
XII (SOCCSKSARGEN),Southern Mindanao Institute of Technology,31,8,1,40
XII (SOCCSKSARGEN),Southern Philippines Methodist College,9,6,0,15
XII (SOCCSKSARGEN),St. Luke's Institute of Technology,9,2,0,11
XII (SOCCSKSARGEN),Sultan Kudarat Educational Institution,22,15,2,39
XII (SOCCSKSARGEN),North Valley College Foundation,31,19,2,52
XII (SOCCSKSARGEN),STI College-Cotabato,50,9,1,60
XII (SOCCSKSARGEN),Central Mindanao Computer School,9,3,2,14
XII (SOCCSKSARGEN),Antonio R. Pacheco College,3,5,1,9
XII (SOCCSKSARGEN),AMA Computer College-Cotabato City,4,3,1,8
XII (SOCCSKSARGEN),Adventist College of Technology,13,9,3,25
XII (SOCCSKSARGEN),Goldenstate College,27,6,0,33
XII (SOCCSKSARGEN),Kutawato Darrusalam College,2,6,3,11
XII (SOCCSKSARGEN),General Santos Doctors' Medical School Foundation,25,13,1,39
XII (SOCCSKSARGEN),Read Data Access Computer College,7,2,0,9
XII (SOCCSKSARGEN),Notre Dame-Siena College of Polomolok,13,7,0,20
XII (SOCCSKSARGEN),Notre Dame RVM College of Cotabato,16,11,1,28
XII (SOCCSKSARGEN),Brokenshire College-Soccsksargen,27,9,2,38
XII (SOCCSKSARGEN),AMA Computer Learning Center College,2,9,0,11
XII (SOCCSKSARGEN),Holy Child College of Information Technology,12,9,0,21
XII (SOCCSKSARGEN),South East Asian Institute of Technology,4,26,2,32
XII (SOCCSKSARGEN),Valdez Mother and Child City College,10,13,5,28
XII (SOCCSKSARGEN),Asian Colleges and Technological Institute,2,4,0,6
XII (SOCCSKSARGEN),Sta. Maria School of Paramedics and Technology,3,1,0,4
XII (SOCCSKSARGEN),Stratford International School,17,17,6,40
XII (SOCCSKSARGEN),ACLC College of Marbel,20,3,0,23
XII (SOCCSKSARGEN),Korbel Foundation College,13,7,1,21
XII (SOCCSKSARGEN),STI College-Koronadal City,2,20,0,22
XII (SOCCSKSARGEN),Microspan Software Technology,7,8,1,16
XII (SOCCSKSARGEN),I-Link College of Science and Technology,4,2,0,6
XII (SOCCSKSARGEN),Coland Systems Technology,14,3,0,17
XII (SOCCSKSARGEN),Goldenstate College of Koronadal City,13,1,0,14
XII (SOCCSKSARGEN),Marvelous College of Technology,18,4,1,23
XII (SOCCSKSARGEN),International Cruise Ship College,8,7,0,15
XII (SOCCSKSARGEN),STI College-Koronadal City-Tacurong City Branch,16,7,0,23
XII (SOCCSKSARGEN),B.E.S.T. College of Polomolok,3,12,1,16
XII (SOCCSKSARGEN),Ramon Magsaysay Memorial College-Marbel,5,10,2,17
XII (SOCCSKSARGEN),General Santos Academy of Polomolok-Cotabato,30,9,1,40
XII (SOCCSKSARGEN),Marbel Institute of Technical College,3,7,3,13
XII (SOCCSKSARGEN),Holy Child College of Information Technology,6,5,0,11
XII (SOCCSKSARGEN),4A School of Excellence,6,7,0,13
XII (SOCCSKSARGEN),Joji Ilagan International School of Hotel and Tourism Management,10,0,0,10
XII (SOCCSKSARGEN),Northpoint College of Arts and Technology,7,11,4,22
XII (SOCCSKSARGEN),MMG School of Paramedics and Allied Sciences,6,2,0,8
XII (SOCCSKSARGEN),Villamor Institute of Technology,0,13,0,13
XII (SOCCSKSARGEN),Cronasia Foundation College,37,8,2,47
XII (SOCCSKSARGEN),Green Valley College Foundation-Isulan Campus,9,3,0,12
NCR (National Capital Region),Adamson University,326,251,38,615
NCR (National Capital Region),Air Link International Aviation College,17,22,3,42
NCR (National Capital Region),Alejandro Colleges,2,4,2,8
NCR (National Capital Region),Alliance Graduate School,3,10,11,24
NCR (National Capital Region),AMA Computer College-Makati,20,18,2,40
NCR (National Capital Region),AMA Computer University,32,38,6,76
NCR (National Capital Region),Arellano University-Manila,121,141,47,309
NCR (National Capital Region),Arellano University-Malabon,8,13,7,28
NCR (National Capital Region),Arellano University-Pasay,15,32,11,58
NCR (National Capital Region),Arellano University-Pasig,22,45,16,83
NCR (National Capital Region),Asia Pacific College,31,69,7,107
NCR (National Capital Region),Asian Institute of Journalism and Communication,0,3,2,5
NCR (National Capital Region),Asian Institute of Maritime Studies,39,44,8,91
NCR (National Capital Region),Asian Seminary of Christian Ministries,9,17,5,31
NCR (National Capital Region),Asian Social Institute,0,9,16,25
NCR (National Capital Region),Asian Theological Seminary,2,10,18,30
NCR (National Capital Region),Assumption College,41,67,2,110
NCR (National Capital Region),Ateneo De Manila University,198,273,150,621
NCR (National Capital Region),Ateneo Graduate School of Business,2,72,15,89
NCR (National Capital Region),Bernardo College,1,23,4,28
NCR (National Capital Region),Biblical Seminary of the Philippines,0,13,12,25
NCR (National Capital Region),University of Asia and the Pacific,18,126,61,205
NCR (National Capital Region),Central Colleges of the Philippines,53,59,8,120
NCR (National Capital Region),Centro Escolar University-Manila,159,289,128,576
NCR (National Capital Region),Chiang Kai Shek College,20,20,6,46
NCR (National Capital Region),Chinese General Hospital College of Nursing and Liberal Arts,11,15,0,26
NCR (National Capital Region),St. Anthony Mary Claret College,0,12,11,23
NCR (National Capital Region),Colegio de San Juan de Letran,62,75,15,152
NCR (National Capital Region),Colegio de San Lorenzo ,22,16,4,42
NCR (National Capital Region),College of the Holy Spirit of Manila,25,22,4,51
NCR (National Capital Region),Concordia College,18,36,4,58
NCR (National Capital Region),Datamex Computer College-Pasay,12,3,3,18
NCR (National Capital Region),De La Salle University-Manila,270,461,319,1050
NCR (National Capital Region),STI College-De Los Santos,22,17,1,40
NCR (National Capital Region),De Ocampo Memorial College,6,9,6,21
NCR (National Capital Region),Divine Word Mission Seminary,4,10,9,23
NCR (National Capital Region),De La Salle-College of St. Benilde,503,258,18,779
NCR (National Capital Region),Dominican College,16,14,2,32
NCR (National Capital Region),Don Bosco Technical College,31,39,4,74
NCR (National Capital Region),Dr. Carlos S. Lanting College,46,57,6,109
NCR (National Capital Region),Emilio Aguinaldo College,83,67,12,162
NCR (National Capital Region),Caritas Family Hospital and Colleges,10,26,1,37
NCR (National Capital Region),Far Eastern University,163,610,132,905
NCR (National Capital Region),FEATI University,62,40,10,112
NCR (National Capital Region),Febias College of Bible,12,14,4,30
NCR (National Capital Region),FEU-FERN College,31,45,3,79
NCR (National Capital Region),FEU-Dr. Nicanor Reyes Medical Foundation,254,92,7,353
NCR (National Capital Region),Governor Andres Pascual College,5,11,11,27
NCR (National Capital Region),Greenville College,2,6,22,30
NCR (National Capital Region),De La Salle-Araneta University ,47,58,11,116
NCR (National Capital Region),Guzman College of Science and Technology,5,9,1,15
NCR (National Capital Region),Holy Rosary College Foundation,11,6,1,18
NCR (National Capital Region),Institute of Community and Family Health,0,8,0,8
NCR (National Capital Region),Institute of Formation and Religious Studies,3,8,11,22
NCR (National Capital Region),Interface Computer College-Manila,5,9,0,14
NCR (National Capital Region),International Academy of Management and Economics,2,13,19,34
NCR (National Capital Region),International Baptist College,8,14,5,27
NCR (National Capital Region),International Graduate School of Leadership,0,10,14,24
NCR (National Capital Region),J.P. Sioson General Hospital and Colleges,0,14,0,14
NCR (National Capital Region),Jose Rizal University,52,119,32,203
NCR (National Capital Region),La Consolacion College-Manila,18,52,10,80
NCR (National Capital Region),La Consolacion College-Caloocan,10,7,6,23
NCR (National Capital Region),Lacson College,5,10,0,15
NCR (National Capital Region),Las Pinas College,12,21,4,37
NCR (National Capital Region),Regis Marie College,11,2,1,14
NCR (National Capital Region),Lyceum of the Philippines University,74,128,29,231
NCR (National Capital Region),Manila Central University,109,99,16,224
NCR (National Capital Region),Manila Tytana Colleges,41,103,6,150
NCR (National Capital Region),Manila Law College,13,4,2,19
NCR (National Capital Region),Manila Adventist Medical Center and Colleges,20,37,7,64
NCR (National Capital Region),Manila Theological College,3,9,7,19
NCR (National Capital Region),Manuel L. Quezon University,54,50,46,150
NCR (National Capital Region),Mapua Institute of Technology-Manila,163,215,23,401
NCR (National Capital Region),Mapua Institute of Technology-Makati,45,45,4,94
NCR (National Capital Region),Martinez Memorial College,18,12,2,32
NCR (National Capital Region),Mary Chiles College,10,14,1,25
NCR (National Capital Region),Mary Johnston College,5,6,1,12
NCR (National Capital Region),CICM Maryhill School of Theology,0,5,20,25
NCR (National Capital Region),Metro Business College-Pasay,5,2,0,7
NCR (National Capital Region),Metro Manila College,18,46,16,80
NCR (National Capital Region),Metropolitan Hospital College of Nursing,21,29,3,53
NCR (National Capital Region),Miriam College,32,176,55,263
NCR (National Capital Region),Mother of Life Center,0,7,8,15
NCR (National Capital Region),Namei Polytechnic Institute,16,13,1,30
NCR (National Capital Region),National College of Business and Arts-Cubao,12,19,4,35
NCR (National Capital Region),National College of Business and Arts-Fairview,30,40,4,74
NCR (National Capital Region),The National Teachers College,58,51,10,119
NCR (National Capital Region),National University,26,111,22,159
NCR (National Capital Region),New Era University,181,112,46,339
NCR (National Capital Region),Olivarez College,57,29,9,95
NCR (National Capital Region),Our Lady of Lourdes College,15,10,4,29
NCR (National Capital Region),Our Lady of the Angels Seminary,3,15,11,29
NCR (National Capital Region),Pace Graduate School of Christian Education,3,4,5,12
NCR (National Capital Region),Pasig Catholic College,23,19,9,51
NCR (National Capital Region),Patts College of Aeronautics,96,8,1,105
NCR (National Capital Region),Perpetual Help College of Manila,32,34,5,71
NCR (National Capital Region),University of Perpetual Help System-Dalta,112,205,30,347
NCR (National Capital Region),Philippine Dominican Center of Institutional Studies,0,14,8,22
NCR (National Capital Region),Philippine Christian University,88,96,39,223
NCR (National Capital Region),Philippine College of Criminology,61,43,25,129
NCR (National Capital Region),Philippine College of Health Sciences,19,32,18,69
NCR (National Capital Region),St. Louis College-Valenzuela,22,7,0,29
NCR (National Capital Region),Philippine Law School,18,1,0,19
NCR (National Capital Region),Philippine Merchant Marine School-Manila,6,2,2,10
NCR (National Capital Region),Philippine Merchant Marine School-Las Pinas,50,42,2,94
NCR (National Capital Region),Philippine School of Business Administration-Quezon City,22,51,6,79
NCR (National Capital Region),Philippine School of Business Administration-Manila,15,33,5,53
NCR (National Capital Region),Philippine Women's University System-Manila,42,121,49,212
NCR (National Capital Region),Philippine Women's University System-Quezon City,9,10,9,28
NCR (National Capital Region),Philsin College Foundation,1,5,3,9
NCR (National Capital Region),Philippine Maritime Institute-Manila,77,19,6,102
NCR (National Capital Region),PMI Colleges-Quezon City,76,17,2,95
NCR (National Capital Region),World Citi Colleges-Quezon City,49,11,5,65
NCR (National Capital Region),Makati Medical Center College of Nursing,10,35,1,46
NCR (National Capital Region),Republican College,16,8,3,27
NCR (National Capital Region),Roosevelt College-Marikina,14,18,1,33
NCR (National Capital Region),St. Cammillus College Seminary,7,11,5,23
NCR (National Capital Region),St. Francis Divine College,3,15,3,21
NCR (National Capital Region),St. Francis of Assisi College,14,17,0,31
NCR (National Capital Region),St. Joseph's College of Quezon City,15,31,5,51
NCR (National Capital Region),St. Jude College,33,75,17,125
NCR (National Capital Region),St. Paul University-Manila (St. Paul Univerity System),18,85,29,132
NCR (National Capital Region),St. Paul University-Quezon City,24,62,15,101
NCR (National Capital Region),St. Rita College-Manila,13,2,4,19
NCR (National Capital Region),St. Scholastica's College,59,121,25,205
NCR (National Capital Region),Samson College of Science and Technology-Quezon City,3,9,4,16
NCR (National Capital Region),San Beda College,110,155,40,305
NCR (National Capital Region),San Carlos Seminary,6,24,12,42
NCR (National Capital Region),San Juan de Dios Educational Foundation,10,29,7,46
NCR (National Capital Region),San Sebastian College-Recoletos,77,79,3,159
NCR (National Capital Region),Sta. Catalina College,0,11,0,11
NCR (National Capital Region),Santa Isabel College,33,44,9,86
NCR (National Capital Region),Siena College,3,22,8,33
NCR (National Capital Region),Southeastern College,4,13,0,17
NCR (National Capital Region),St. Luke's College of Medicine-William H. Quasha Memorial,130,19,8,157
NCR (National Capital Region),St. Rita Hospital College of Nursing and School of Midwifery,10,13,2,25
NCR (National Capital Region),Stella Maris College,7,9,0,16
NCR (National Capital Region),System Plus Computer College-Quezon City,8,9,1,18
NCR (National Capital Region),Technological Institute of the Philippines-Manila,111,128,20,259
NCR (National Capital Region),Technological Institute of The Philippines-Quezon City,163,192,30,385
NCR (National Capital Region),Trinity University of Asia,45,128,46,219
NCR (National Capital Region),Unciano Colleges and General Hospital,16,4,0,20
NCR (National Capital Region),Southeast Asian College,26,33,8,67
NCR (National Capital Region),University of the East Ramon Magsaysay Memorial Medical Center,253,82,9,344
NCR (National Capital Region),University of Manila ,119,75,29,223
NCR (National Capital Region),University of Santo Tomas,694,903,194,1791
NCR (National Capital Region),University of the East-Manila,181,347,86,614
NCR (National Capital Region),University of the East-Caloocan,95,51,7,153
NCR (National Capital Region),Angelicum College,14,15,7,36
NCR (National Capital Region),Asian College of Science and Technology-Cubao,21,14,3,38
NCR (National Capital Region),Don Bosco Center of Studies,1,9,13,23
NCR (National Capital Region),Abraham Dumlao Colleges of the Philippines,3,0,1,4
NCR (National Capital Region),FEU-East Asia College,69,146,13,228
NCR (National Capital Region),IETI College-Alabang,5,14,2,21
NCR (National Capital Region),Our Lady of Perpetual Succor College,17,10,5,32
NCR (National Capital Region),San Beda College-Alabang,41,81,9,131
NCR (National Capital Region),St. Dominic Savio College,18,21,4,43
NCR (National Capital Region),St. John Technological College of the Philippines,22,5,1,28
NCR (National Capital Region),STI College-Alabang,15,5,0,20
NCR (National Capital Region),STI College-Cubao,29,14,1,44
NCR (National Capital Region),STI College-EDSA Crossing,21,9,1,31
NCR (National Capital Region),STI Education Services Group-Global City,59,39,3,101
NCR (National Capital Region),STI College-Caloocan,37,33,2,72
NCR (National Capital Region),STI College-Makati,24,6,0,30
NCR (National Capital Region),STI College-Munoz EDSA,49,8,0,57
NCR (National Capital Region),STI College-Novaliches,39,13,2,54
NCR (National Capital Region),STI Education Services Group-Fairview,0,37,1,38
NCR (National Capital Region),STI College-Taft,24,9,0,33
NCR (National Capital Region),STI College-Recto,30,6,2,38
NCR (National Capital Region),Philippine Rehabilitation Institute Foundation,12,19,0,31
NCR (National Capital Region),Immaculada Concepcion Colleges,2,10,3,15
NCR (National Capital Region),O.B. Montessori Center,9,5,2,16
NCR (National Capital Region),West Bay College,30,11,0,41
NCR (National Capital Region),System Plus Computer College-Caloocan,5,5,0,10
NCR (National Capital Region),St. Bernadette College of Alabang,9,12,4,25
NCR (National Capital Region),Children of Mary Immaculate College,9,5,0,14
NCR (National Capital Region),Nova Computer College,5,3,0,8
NCR (National Capital Region),Informatics College-Manila,6,7,0,13
NCR (National Capital Region),The Fisher Valley College,1,27,4,32
NCR (National Capital Region),La Consolacion College-Deparo,12,11,2,25
NCR (National Capital Region),ABE International College of Business and Economics-Legarda,16,2,0,18
NCR (National Capital Region),AMA Computer College-Caloocan,15,0,0,15
NCR (National Capital Region),AMA Computer College-Fairview,5,18,0,23
NCR (National Capital Region),AMA Computer College-Paranaque,2,14,0,16
NCR (National Capital Region),AMA Computer College-Sta. Mesa,13,7,0,20
NCR (National Capital Region),Asia School of Arts and Sciences,10,2,3,15
NCR (National Capital Region),Child Jesus College,0,7,0,7
NCR (National Capital Region),Divine Mercy College Foundation,35,9,12,56
NCR (National Capital Region),Tech Pacific College,2,4,1,7
NCR (National Capital Region),Informatics College-Caloocan,3,12,1,16
NCR (National Capital Region),Interface Computer College-Caloocan,10,8,0,18
NCR (National Capital Region),Our Lady of Fatima University-Quezon City,66,84,5,155
NCR (National Capital Region),Our Lady of Lourdes Technological College,2,11,2,15
NCR (National Capital Region),St. Clare College of Caloocan,21,16,8,45
NCR (National Capital Region),St. James College of Quezon City,8,16,1,25
NCR (National Capital Region),STI College-Las Pinas,28,13,0,41
NCR (National Capital Region),STI College-Paranaque,5,14,3,22
NCR (National Capital Region),Asia Graduate School of Theology,0,0,12,12
NCR (National Capital Region),AMA Computer College-Las Pinas,9,9,1,19
NCR (National Capital Region),AMA Computer College-Pasig City,18,3,1,22
NCR (National Capital Region),Wesleyan College of Manila,8,16,6,30
NCR (National Capital Region),Loral Douglas Woosley Bethany Colleges,15,7,2,24
NCR (National Capital Region),STI College-Marikina,8,4,2,14
NCR (National Capital Region),IETI College of Science and Technology-Marikina,9,7,1,17
NCR (National Capital Region),Manila Business College,14,8,7,29
NCR (National Capital Region),St. James College of Paranaque,5,7,3,15
NCR (National Capital Region),Access Computer and Technical Colleges-Manila,6,4,1,11
NCR (National Capital Region),Kalayaan College,13,26,7,46
NCR (National Capital Region),Criminal Justice College,4,9,4,17
NCR (National Capital Region),Entrepreneurs School of Asia,9,16,1,26
NCR (National Capital Region),Asian Institute of Computer Studies,9,2,1,12
NCR (National Capital Region),St. Mary's College,10,20,7,37
NCR (National Capital Region),ABE International College of Business and Accountancy-Cubao,15,12,1,28
NCR (National Capital Region),ABE International College of Business and Accountancy-Las Pinas,12,12,0,24
NCR (National Capital Region),National Christian Life College,1,9,2,12
NCR (National Capital Region),Global City Innovative College,38,48,3,89
NCR (National Capital Region),Center for Early Childhood Care and Development,1,7,1,9
NCR (National Capital Region),Southville International School and Colleges,20,47,7,74
NCR (National Capital Region),Information and Communications Technology Academy,29,16,3,48
NCR (National Capital Region),Our Lady of Guadalupe Colleges,9,13,0,22
NCR (National Capital Region),STI College-Quezon Avenue,19,18,0,37
NCR (National Capital Region),The Manila Times College,2,7,2,11
NCR (National Capital Region),Access Computer and Technical Colleges-Quezon City,5,6,2,13
NCR (National Capital Region),Immaculate Heart of Mary College-Paranaque,5,19,12,36
NCR (National Capital Region),Lyceum of Alabang,12,26,6,44
NCR (National Capital Region),Rogationist Seminary College,9,16,3,28
NCR (National Capital Region),La Consolacion College-Pasig,8,12,2,22
NCR (National Capital Region),Kester Grant College Philippines,10,14,1,25
NCR (National Capital Region),Informatics College-Quezon City,24,4,4,32
NCR (National Capital Region),ABE International Business College-Caloocan City,15,7,0,22
NCR (National Capital Region),Informatics College-Eastwood,4,12,1,17
NCR (National Capital Region),World Citi Colleges-Caloocan,11,5,0,16
NCR (National Capital Region),Colegio de Santa Monica-Manila,9,10,3,22
NCR (National Capital Region),Informatics College-Northgate,10,3,2,15
NCR (National Capital Region),St. Bernadette College of Health and Sciences,2,20,9,31
NCR (National Capital Region),Mary the Queen College of Science and Technology,4,28,2,34
NCR (National Capital Region),St. Bernadette of Lourdes College,3,12,5,20
NCR (National Capital Region),Flight School International,8,6,2,16
NCR (National Capital Region),Capitol Medical Center Colleges,2,16,3,21
NCR (National Capital Region),St. Pedro Poveda College,12,15,0,27
NCR (National Capital Region),St. Mary's College of San Juan,0,10,0,10
NCR (National Capital Region),New England College,8,19,1,28
NCR (National Capital Region),Universal Colleges of Paranaque,19,17,3,39
NCR (National Capital Region),ABE International College of Business and Accountancy-Taft,12,8,1,21
NCR (National Capital Region),St. John of Beverly School,12,3,2,17
NCR (National Capital Region),NOVAGEN College of Quezon City,12,14,0,26
NCR (National Capital Region),Jesus Reigns Christian College Foundation,1,31,11,43
NCR (National Capital Region),Villagers Montessori College,19,10,3,32
NCR (National Capital Region),AMA School of Medicine,16,0,0,16
NCR (National Capital Region),Sta. Cecilia College,3,13,1,17
NCR (National Capital Region),Enderun College,33,38,11,82
NCR (National Capital Region),Messiah College Foundation,8,13,4,25
NCR (National Capital Region),National Polytechnic College of Science and Technology,6,20,4,30
NCR (National Capital Region),Lady of Lourdes Hospital and Colleges of Caybiga,7,5,1,13
NCR (National Capital Region),College of St. Catherine,6,11,0,17
NCR (National Capital Region),Grace Christian College,8,23,5,36
NCR (National Capital Region),Centro Escolar University-Makati,61,60,18,139
NCR (National Capital Region),Philippine Cultural College,8,18,3,29
NCR (National Capital Region),Diliman Computer Technology Institute,15,13,3,31
NCR (National Capital Region),The One Nation Entrepreneur School,0,9,1,10
NCR (National Capital Region),Bestlink College of the Philippines,110,61,11,182
NCR (National Capital Region),Global Reciprocal Colleges,18,52,6,76
NCR (National Capital Region),Golden Link College Foundation,20,4,2,26
NCR (National Capital Region),ACLC College of Taguig,13,10,1,24
NCR (National Capital Region),Asian Institute of Computer Studies-Quezon City,6,3,0,9
NCR (National Capital Region),Far Eastern University-Makati,13,59,11,83
NCR (National Capital Region),St. Dominic Institute,3,9,3,15
NCR (National Capital Region),Treston International College,9,13,2,24
NCR (National Capital Region),ABE International Business College-Makati City,4,8,0,12
NCR (National Capital Region),Access Computer and Technical Colleges-Lagro,3,5,1,9
NCR (National Capital Region),Facilities Management College,7,8,0,15
NCR (National Capital Region),ABE International Business College-Commonwealth,11,8,0,19
NCR (National Capital Region),College of Divine Wisdom,2,7,5,14
NCR (National Capital Region),La Consolacion College-Valenzuela,1,8,0,9
NCR (National Capital Region),AMA Computer College-Mandaluyong,5,4,0,9
NCR (National Capital Region),South SEED LPDH College,3,8,0,11
NCR (National Capital Region),Bethel Bible College of the Assemblies of God,5,8,0,13
NCR (National Capital Region),Christ the King College of Science and Technology,2,32,2,36
NCR (National Capital Region),St. Vincent de Ferrer College of Camarin,10,23,11,44
NCR (National Capital Region),Datamex-College of St. Adeline-Fairview,2,6,2,10
NCR (National Capital Region),Access Computer and Technical College-Camarin,3,4,2,9
NCR (National Capital Region),Datamex-College of St. Adeline-Valenzuela,2,6,2,10
NCR (National Capital Region),School of Fashion and the Arts,13,10,0,23
NCR (National Capital Region),PNTC Colleges-Manila,5,8,5,18
NCR (National Capital Region),La Verdad Christian College-Caloocan,15,11,2,28
NCR (National Capital Region),Arellano University-Mandaluyong,9,11,1,21
CAR (Cordillera Administrative Region),Abra Valley Colleges,55,19,1,75
CAR (Cordillera Administrative Region),Baguio Central University,88,61,28,177
CAR (Cordillera Administrative Region),University of the Cordilleras,126,229,36,391
CAR (Cordillera Administrative Region),Cordillera Career Development College,61,26,5,92
CAR (Cordillera Administrative Region),Divine Word College of Bangued,37,31,9,77
CAR (Cordillera Administrative Region),Philippine Nazarene College,10,13,1,24
CAR (Cordillera Administrative Region),Pines City Colleges,47,20,1,68
CAR (Cordillera Administrative Region),St. Louis College of Bulanao,16,15,4,35
CAR (Cordillera Administrative Region),St. Louis University,562,389,48,999
CAR (Cordillera Administrative Region),San Pablo Major Seminary,5,9,11,25
CAR (Cordillera Administrative Region),Casiciaco Recoletos Seminary,0,11,10,21
CAR (Cordillera Administrative Region),University of Baguio,142,197,49,388
CAR (Cordillera Administrative Region),Easter College,29,19,0,48
CAR (Cordillera Administrative Region),Keystone College,12,8,3,23
CAR (Cordillera Administrative Region),STI Education Group Services,20,10,0,30
CAR (Cordillera Administrative Region),Baguio College of Technology,18,14,1,33
CAR (Cordillera Administrative Region),BVS College,5,8,2,15
CAR (Cordillera Administrative Region),International Christian Colleges ,4,3,1,8
CAR (Cordillera Administrative Region),Cordillera A+ Computer Technology College,17,7,0,24
CAR (Cordillera Administrative Region),AMA Computer College-Baguio,11,10,0,21
CAR (Cordillera Administrative Region),Data Center College of the Philippines of Bangued-Abra,24,12,0,36
CAR (Cordillera Administrative Region),Kalinga Colleges of Science and Technology,18,9,0,27
CAR (Cordillera Administrative Region),Data Center College of the Philippines of Baguio City,16,7,0,23
CAR (Cordillera Administrative Region),Philippines Women's University-Baguio City,23,10,5,38
CAR (Cordillera Administrative Region),Baguio Christian Mission International College,6,3,3,12
CAR (Cordillera Administrative Region),Kings Colleges of the Philippines-Benguet,65,33,10,108
CAR (Cordillera Administrative Region),St. Tonis College,7,17,3,27
CAR (Cordillera Administrative Region),Colegio Nacional,10,17,9,36
CAR (Cordillera Administrative Region),BSBT College,21,6,0,27
CAR (Cordillera Administrative Region),Xijen College of Mt. Province,11,3,2,16
CAR (Cordillera Administrative Region),Pinnacle Colleges of Bangued,8,2,0,10
CAR (Cordillera Administrative Region),Baguio City Academy Colleges,9,2,1,12
CAR (Cordillera Administrative Region),HML International College,7,3,1,11
CAR (Cordillera Administrative Region),Remnant International School ,6,10,4,20
CAR (Cordillera Administrative Region),Triniville Central College ,4,4,2,10
CAR (Cordillera Administrative Region),International School of Asia and the Pacific-Tabuk Branch,22,5,0,27
ARMM (Autonomous Region in Muslim Mindanao),Jamiatu Marawi Al-Islamia Foundation,19,5,1,25
ARMM (Autonomous Region in Muslim Mindanao),Jamiatu Muslim Mindanao,4,7,5,16
ARMM (Autonomous Region in Muslim Mindanao),Jamiatul Philippine Al-Islamia,26,2,2,30
ARMM (Autonomous Region in Muslim Mindanao),Datu Mala-Muslim Mindanao Islamic College Foundation,9,4,2,15
ARMM (Autonomous Region in Muslim Mindanao),Gani L. Abpi Colleges,13,3,2,18
ARMM (Autonomous Region in Muslim Mindanao),Notre Dame of Jolo College,83,37,2,122
ARMM (Autonomous Region in Muslim Mindanao),Shariff Kabunsuan College-Annex,0,11,9,20
ARMM (Autonomous Region in Muslim Mindanao),Sultan Kudarat Islamic Academy Foundation College,9,2,0,11
ARMM (Autonomous Region in Muslim Mindanao),Southwestern Mindanao Islamic Institute,20,13,2,35
ARMM (Autonomous Region in Muslim Mindanao),Abubakar Computer Learning Center Foundation,36,4,0,40
ARMM (Autonomous Region in Muslim Mindanao),Lanao Educational Institute,13,3,4,20
ARMM (Autonomous Region in Muslim Mindanao),Mahardika Institute of Technology,68,24,4,96
ARMM (Autonomous Region in Muslim Mindanao),Sal Foundation College,1,5,2,8
ARMM (Autonomous Region in Muslim Mindanao),Mindanao Autonomous College Foundation,21,6,2,29
ARMM (Autonomous Region in Muslim Mindanao),Datu Ibrahim Paglas Memorial College,13,7,1,21
ARMM (Autonomous Region in Muslim Mindanao),Saffrullah M. Dipatuan Foundation Academy,18,4,2,24
ARMM (Autonomous Region in Muslim Mindanao),Southern Philippines College of Sciences and Health Education,28,5,0,33
ARMM (Autonomous Region in Muslim Mindanao),Mariam School of Nursing,9,7,0,16
ARMM (Autonomous Region in Muslim Mindanao),Alexian College of Parang,6,5,1,12
ARMM (Autonomous Region in Muslim Mindanao),Lanao College of Criminology,16,1,0,17
ARMM (Autonomous Region in Muslim Mindanao),Lake Lanao College,12,3,1,16
ARMM (Autonomous Region in Muslim Mindanao),Hiland Institute Colleges,5,2,0,7
ARMM (Autonomous Region in Muslim Mindanao),Datu Blo Umpar Adiong Agricultural School Foundation,5,1,0,6
ARMM (Autonomous Region in Muslim Mindanao),Bai Malgen Mama College,12,0,1,13
ARMM (Autonomous Region in Muslim Mindanao),Al Kwarizmi International College Foundation,19,7,5,31
ARMM (Autonomous Region in Muslim Mindanao),Hardam Furigay Colleges Foundation,24,7,1,32
XIII (Caraga),Agusan Business and Arts Foundation,10,1,0,11
XIII (Caraga),Agusan Colleges,19,10,7,36
XIII (Caraga),Agusan Del Sur College,47,12,5,64
XIII (Caraga),Agusan Institute of Technology,5,30,0,35
XIII (Caraga),Asian College Foundation,9,4,0,13
XIII (Caraga),Butuan City Colleges,25,5,1,31
XIII (Caraga),Butuan Doctors' College,27,14,2,43
XIII (Caraga),Don Jose Ecleo Memorial Foundation College of Science and Technology,13,13,2,28
XIII (Caraga),Elisa R. Ochoa Memorial Northern Mindanao School of Midwifery,14,4,2,20
XIII (Caraga),New Northern Mindanao Colleges,50,10,2,62
XIII (Caraga),Northwestern Agusan Colleges,21,7,1,29
XIII (Caraga),St. Francis Xavier College,37,6,1,44
XIII (Caraga),St. Joseph Institute of Technology,86,14,9,109
XIII (Caraga),St. Jude Thaddeus Institute of Technology,28,3,2,33
XIII (Caraga),San Francisco Colleges,12,5,0,17
XIII (Caraga),St. Paul University Surigao,41,51,15,107
XIII (Caraga),Surigao Education Center,63,27,3,93
XIII (Caraga),Father Saturnino Urios University,174,84,30,288
XIII (Caraga),West Agusan Colleges,11,4,1,16
XIII (Caraga),Northeastern Mindanao Colleges,37,16,6,59
XIII (Caraga),Andres Soriano College,12,10,3,25
XIII (Caraga),St. Michael's College Cantilan,17,11,2,30
XIII (Caraga),St. Theresa College of Tandag,18,13,4,35
XIII (Caraga),St. Vincent de Paul Diocesan College,29,1,0,30
XIII (Caraga),Southern Technological Institute of the Philippines,36,2,1,39
XIII (Caraga),Surigao Sur Colleges,8,2,0,10
XIII (Caraga),Siargao Island Institute of Technology,33,12,2,47
XIII (Caraga),Caraga Institute of Technology,25,5,0,30
XIII (Caraga),De La Salle John Bosco College,54,12,1,67
XIII (Caraga),Mt. Carmel College of San Francisco,16,11,1,28
XIII (Caraga),Sunrise Christian College Foundation of the Philippines,11,2,2,15
XIII (Caraga),St. Michael College of Caraga,20,22,2,44
XIII (Caraga),Southway College of Technology,33,4,0,37
XIII (Caraga),Holy Child Colleges of Butuan City,18,24,7,49
XIII (Caraga),STI College-Surigao,18,5,0,23
XIII (Caraga),Balite Institute of Technology-Butuan,0,9,2,11
XIII (Caraga),St. Peter College Seminary,5,7,1,13
XIII (Caraga),Bucas Grande Foundation College,4,9,5,18
XIII (Caraga),ACLC College of Butuan City,31,9,0,40
XIII (Caraga),Philippine Electronics and Communication Institute of Technology,12,9,1,22
XIII (Caraga),Rafael A. Mondejar Memorial College,7,2,1,10
XIII (Caraga),Caraga Computer College,7,2,1,10
XIII (Caraga),Golden Gate International Career Institute,4,7,1,12
XIII (Caraga),Candelaria Institute of Cabadbaran,6,1,1,8
V-B (MIMAROPA),Abada College,26,14,3,43
V-B (MIMAROPA),Colegio De San Sebastian-Sablayan,20,8,0,28
V-B (MIMAROPA),Divine Word College of Calapan,76,61,14,151
V-B (MIMAROPA),Divine Word College of San Jose,27,24,3,54
V-B (MIMAROPA),Eastern Mindoro College,16,3,0,19
V-B (MIMAROPA),EMA EMITS College Philippines,6,10,0,16
V-B (MIMAROPA),Grace Mission College,9,5,1,15
V-B (MIMAROPA),Holy Trinity University,39,34,10,83
V-B (MIMAROPA),St. Mary's College of Marinduque,14,5,0,19
V-B (MIMAROPA),Loyola College of Culion,10,4,0,14
V-B (MIMAROPA),Luna Goco Colleges-Calapan,19,12,1,32
V-B (MIMAROPA),Palawan Polytechnic College,21,16,4,41
V-B (MIMAROPA),St. Augustine Seminary,0,13,2,15
V-B (MIMAROPA),San Francisco Javier College,14,3,0,17
V-B (MIMAROPA),Santa Cruz Institute,7,14,0,21
V-B (MIMAROPA),Seminario De San Jose,5,5,1,11
V-B (MIMAROPA),Educational Systems Technological Institute,21,4,1,26
V-B (MIMAROPA),"CLCC Institute of Computer, Arts and Technology",4,5,0,9
V-B (MIMAROPA),Fullbright College,41,7,2,50
V-B (MIMAROPA),Marinduque Midwest College,24,14,1,39
V-B (MIMAROPA),Prince of Peace College,7,1,1,9
V-B (MIMAROPA),John Paul College,16,26,5,47
V-B (MIMAROPA),San Lorenzo Ruiz Seminary,7,3,0,10
V-B (MIMAROPA),Clarendon College,1,25,1,27
V-B (MIMAROPA),Mina de Oro Institute of Science and Technology,6,5,0,11
V-B (MIMAROPA),ACMCL College,1,6,0,7
V-B (MIMAROPA),Palawan Technological College,3,13,3,19
V-B (MIMAROPA),IATEC Computer College,12,4,0,16
V-B (MIMAROPA),Innovative College of Science and Technology,38,8,1,47
V-B (MIMAROPA),St. Anthony College of Calapan City,11,21,4,36
V-B (MIMAROPA),Southwestern Institute of Business and Technology,7,10,3,20
V-B (MIMAROPA),Paradigm College of Science and Technology,21,11,1,33
V-B (MIMAROPA),Erhard Systems Technological Institute,13,13,2,28
V-B (MIMAROPA),Institute of Business Science and Medical Arts,14,3,0,17
V-B (MIMAROPA),Philippine Central Islands College Foundation,10,9,1,20
V-B (MIMAROPA),ACLC College of Calapan,12,5,2,19
V-B (MIMAROPA),Pinamalayan Maritime Foundation and Technological Institute,11,11,0,22
V-B (MIMAROPA),STI College-Puerto Princesa,11,4,0,15
V-B (MIMAROPA),Remnant Christian College-Palawan,1,6,1,8
V-B (MIMAROPA),Luna Goco College-Roxas,6,0,0,6
Grand Total, Grand Total ,43577,33992,8432,86001
